# A POS tag dictionary that's used as an addition (or as a fix) to catalan.dict
# These words are candidates to be added (or fixed) in catalan.dict in the future
# File Encoding: UTF-8
# Format: fullform baseform postags (tab separated)
########## Dictionary fixes ##########
########## Additions ##########
betlemisme	betlemisme	NCMS000
betlemismes	betlemisme	NCMP000
betlemista	betlemista	AQ0CS0
betlemista	betlemista	NCCS000
betlemistes	betlemista	AQ0CP0
betlemistes	betlemista	NCCP000
handicap	handicap	NCMS000
handicaps	handicap	NCMP000
pesebre	pesebre	NCMS000
pesebres	pesebre	NCMP000
pesebrisme	pesebrisme	NCMS000
pesebrismes	pesebrisme	NCMP000
pesebrista	pesebrista	AQ0CS0
pesebrista	pesebrista	NCCS000
pesebristes	pesebrista	AQ0CP0
pesebristes	pesebrista	NCCP000
pesebrístic	pesebrístic	AQ0MS0
pesebrística	pesebrístic	AQ0FS0
pesebrístics	pesebrístic	AQ0MP0
pesebrístiques	pesebrístic	AQ0FP0
pessebrista	pessebrista	AQ0CS0
pessebristes	pessebrista	AQ0CP0
