# @author Ruud Baars (info@taaltik.nl)
#format:error=alternative|alternative
zondermeer=zonder meer
alledrie=alle drie
niét=niet|níét
tewerk=te werk
vandien=van dien
weldegelijk=wel degelijk
face-to-face=face to face
okay=oké
temidden=te midden
zonodig=zo nodig
etcetera=et cetera
predikaat=predicaat|predikant
vantevoren=van tevoren
zometeen=zo meteen
zoniet=zo niet
zorgdragen=zorg dragen
da's=dat is
huis-aan-huis=huis aan huis
last-minute=last minute
bijelkaar=bij elkaar
communities=community's
ookal=ook al
vanalles=van alles
iedergeval=ieder geval
laaste=laatste
maarja=maar ja
maarliefst=maar liefst
opzich=op zich
snachts='s nachts
accoord=akkoord
laatse=laatste
mischien=misschien
news=nieuws
savonds='s avonds
glas-in-lood=glas in lood
moederdag=Moederdag
state-of-the-art=state of the arte|modern
technology=technologie
here=Here|heer|Heer
copy=kopie
doormiddel=door middel
fairtrade=fair trade
openhaard=open haard
d'r=haar|daar
bass=bas
buro=bureau
responsive=responsief|responsie|responsieve
roestvrijstaal=roestvrij staal
kunstof=kunststof
stap-voor-stap=stap voor stap
dat-ie=dat hij
hogedruk=hoge druk
's-avonds='s avonds
smorgens='s morgens
eeen=een
must-have=must have
deluxe=de luxe
alswel=als wel
ad-hoc=ad hoc
jammergenoeg=jammer genoeg
nouja=nou ja
in't=in 't|in het
barbecuen=barbecueën
goedkomen=goed komen
optijd=op tijd
alletwee=alle twee
meerjaren=meer jaren
nogsteeds=nog steeds
warmwater=warm water
musthave=must have
voor-en=voor- en
euri=euro's
to-do=to do
achterkomen=achter komen
is-ie=is ie|is hij
terplekke=ter plekke
smiddags='s middags
out-of-the-box=out of the box
dondersgoed=donders goed
ervanuit=er vanuit|ervan uit
allertijden=aller tijden
langsgeweest=langs geweest
aant=aan het|aan 't|aant.
boutique=boetiek
zovaak=zo vaak
thuisvoelen=thuis voelen
uitelkaar=uit elkaar
's-nachts='s nachts
ergenis=ergernis
zoiezo=sowieso
stijle=steile
lange-termijn=lange termijn
bijde=beide|bij de
low-budget=AOW-budget
paul=Paul|PAUL|paal|paus|Paula|Paulo|Saul|pal|pauw|Pauli|Pauls|Raul|Raúl|pauk|peul|prul|pul|Pauly|SAUL|páál
gevraagt=gevraagd|gedraagt|bevraagt|gevraag|gevráágd|gedráágt
veeel=veel
ookwel=ook wel
opweg=op weg
# wijdse=wijdde|wijde|wijds|wijdst|wijdste|wijdte\
#
#
terzake=ter zake
notabene=nota bene
zondermeer=zonder meer
alledrie=alle drie
ipv=i.p.v.|in plaats van
ofzo=of zo
idd=inderdaad
zn=zijn|z'n
mn=mijn|m'n
voorzover=voor zover
ondermeer=onder meer
ivm=i.v.m.|in verband met
eenderde=een derde
tweederde=twee derde
tengevolge=ten gevolge
cq=c.q.
dmv=d.m.v.|door middel van
oid=o.i.d.|of iets dergelijks
ff=even
maargoed=maar goed
stofgezogen=gestofzuigd
normaalgesproken=normaal gesproken
doormiddel=door middel
limoenamandelcake=limoen-amandelcake
USA=VS|Verenigde Staten
terzake=ter zake
enzo=en zo
terzake=ter zake
iig=i.i.g.
da's=dat is
zonodig=zo nodig
mbt=m.b.t.
aub=a.u.b.
bbq=barbecue
mss=misschien
Fryslân=Friesland
temidden=te midden
tov=t.o.v.
bvb=bijvoorbeeld|bijv.
vanalles=van alles
kwa=qua
Rabo=Rabobank
doormiddel=door middel
persé=per se
alledrie=alle drie
maarja=maar ja
t='t|het
goedzo=goed zo
ZZP=zzp
zoniet=zo niet
tbv=t.b.v.
accoord=akkoord
gwn=gewoon
zorgdragen=zorg dragen
