# @author Susana Sotelo
#
# Replace incorrect words
# Format:
#
# incorrect=correct

aceira=beirarrúa
aceiras=beirarrúas
alomenos=polo menos
anque=aínda que
asimesmo=así mesmo
carreteira=estrada
carreteiras=estradas
entonces=entón
achádego=achado
achádegos=achados
cofeito=suborno
cofeitos=subornos
lexanía=distancia
lexanías=distancias
lexía=lixivia
lexías=lixivias
maiordomo=mordomo
maiordomos=mordomos
mediciña=medicina
mediciñas=medicinas
mentras=mentres
partixa=partilla
partixas=partillas
soxa=soia
soxas=soias
varniz=verniz
varnices=vernices
vasixa=vasilla
vasixas=vasillas
verquido=vertedura
verquidos=verteduras
xaula=gaiola
xaulas=gaiolas
