#Common English contractions
#Used because our speller dictionaries
#do not include forms with the apostrophe 
#(c) 2013 Marcin Milkowski
#Licensed under LGPL
aint=ain't
arent=aren't
#cant=can't
couldnt=couldn't
didnt=didn't
doesnt=doesn't
dont=don't
hadnt=hadn't
hasnt=hasn't
havent=haven't
hed=he'd
#hell=he'll #too ambiguous
hes=he's
howd=how'd
hows=how's
howll=how'll
Id=I'd
Ill=I'll
Im=I'm
Ive=I've
isnt=isn't
#its=it's
#lets=let's
mightnt=mightn't
mustve=must've
mustnt=mustn't
neednt=needn't
oclock=o'clock
shant=shan't
#shed=she'd
#shell=she'll
shes=she's
shouldve=should've
shouldnt=shouldn't
thatd=that'd
thats=that's
thered=there'd
theres=there's
theyd=they'd
theyll=they'll
theyre=they're
theyve=they've
wasnt=wasn't
wed=we'd
#were=we're
#well=we'll
weve=we've
werent=weren't
whatll=what'll
whatre=what're
whats=what's
whatre=what're
whatve=what've
whens=when's
wheres=where's
whereve=where've
whod=who'd
wholl=who'll
#whore=who're
whos=who's
whove=who've
whys=why's
#wont=won't
wouldve=would've
wouldnt=wouldn't
yall=y'all
youd=you'd
youll=you'll
youre=you're
youve=you've