# Based on After the Dealine
# words to insert accented characters into
#

a contrecaeur=à contrecœur
a gogo=à gogo
a la=à la
a la carte=à la carte
a la mode=à la mode
a propos=à propos
abbe=abbé
acai=açai
aide-memoire=aide-mémoire
akaganeite=akaganéite
akce=akçe
akermanite=åkermanite
ancien regime=ancien régime
anekantavada=anekāntavāda
anudatta=anudātta
apercu=aperçu
aperitif=apéritif
appellation controlee=appellation contrôlée
applique=appliqué
apres=après
apres-ski=après-ski
apres-skiing=après-skiing
apropos=àpropos
arete=arête
arriere-pensee=arrière-pensée
attache=attaché
attache case=attaché case
auto da fe=auto da fé
auto de fe=auto de fé
auto-da-fe=auto-da-fé
barege=barège
bayadere=bayadère
bearnaise=béarnaise
bearnaise sauce=béarnaise sauce
beau ideal=beau idéal
bechamel=béchamel
bechamel sauce=béchamel sauce
beche-de-mer=bêche-de-mer
beguin=béguin
belle epoque=belle époque
bergere=bergère
bete noire=bête noire
betise=bêtise
bhumi=bhūmi
blase=blasé
blodite=blödite
bobeche=bobèche
bolivar=bolívar
bombe=bombé
bon appetit=bon appétit
bonbonniere=bonbonnière
bouchee=bouchée
boucle=bouclé
bourree=bourrèe
brassiere=brassière
# bric-a-brac=bric-à-brac
brotchen=brötchen
bukovskyite=bukovskýite
cabecou=cabécou
cafe=café
# cafe is very withspread. May be reconsidered.
cafe au lait=café au lait
cafe noir=café noir
cafe noisette=café noisette
cafetiere=cafetière
caffe americano=caffè americano
caffe latte=caffè latte
caic=caïc
caique=caïque
caiquejee=caïquejee
caleche=calèche
canape=canapé
candiru=candirú
catalogue raisonne=catalogue raisonné
cause celebre=cause célèbre
centzontle=centzontlé
cepage=cépage
chacun a son gout=chacun à son goût
charge d'affaires=chargé d'affaires
chasse=chassé
chateau=château
chateaubriand=châteaubriand
chef-d'aeuvre=chef-d'œuvre
chevre=chèvre
chateaux=châteaux
cine film=ciné film
cinefilm=cinéfilm
cinema verite=cinéma vérité
cire=ciré
cliche=cliché
cliche-ridden=cliché-ridden
cliche-verre=cliché-verre
cliched=clichéd
clicheed=clichéed
cloisonne=cloisonné
comme ci comme ca=comme ci comme ça
commere=commère
communique=communiqué
compere=compère
confrere=confrère
consomme=consommé
conte=conté
contourne=contourné
cordoba=córdoba
cortege=cortège
corvee=corvée
coryphee=coryphée
coule=coulé
coup detat=coup d'état
coup de grace=coup de grâce
coup de theatre=coup de théâtre
coupe=coupé
# coupe is very withspread. May be reconsidered.
coups d'etat=coups d'état
# creature=creäture
creche=crèche
creme=crème
creme anglaise=crème anglaise
creme brulee=crème brûlée
creme caramel=crème caramel
creme de cacao=crème de cacao
creme de cassis=crème de cassis
creme de la creme=crème de la crème
creme de menthe=crème de menthe
creme fraiche=crème fraîche
crepe=crêpe
crepe de chine=crêpe de chine
crepe paper=crêpe paper
creperie=crêperie
crepy=crêpy
croise=croisé
cross pattee=cross pattée
crudites=crudités
curacao=curaçao
cy-pres=cy-près
cybercafe=cybercafé
coup d'etat=coup d'état
coup de grace=coup de grâce
coup de theatre=coup de théâtre
coupe=coupé
coups d'etat=coups d'état
creature=creäture
creche=crèche
creme=crème
creme anglaise=crème anglaise
creme brulee=crème brûlée
creme caramel=crème caramel
creme de cacao=crème de cacao
creme de cassis=crème de cassis
creme de la creme=crème de la crème
creme de menthe=crème de menthe
creme fraiche=crème fraîche
crepe=crêpe
crepe de chine=crêpe de chine
crepe paper=crêpe paper
creperie=crêperie
crepy=crêpy
croise=croisé
cross pattee=cross pattée
crudites=crudités
curacao=curaçao
cy-pres=cy-près
cybercafe=cybercafé
dais=daïs
damasse=damassé
debridement=débridement
debut=début
decolletage=décolletage
decollete=décolleté
decolletee=décolletée
degage=dégagé
deja vu=déjà vu
demarche=démarche
denouement=dénouement
depanneur=dépanneur
departement=département
derriere=derrière
detente=détente
developpe=développé
devore=devoré
diamante=diamanté
differance=différance
distingue=distingué
distinguee=distinguée
donnee=donnée
doppelganger=doppelgänger
dos-a-dos=dos-à-dos
dragee=dragée
drophead coupe=drophead coupé
echappe=échappé
eclair=éclair
eclat=éclat
ecorche=écorché
ecossaise=écossaise
ecoute=écoute
ecu=écu
elan=élan
elan vital=élan vital
# elite=élite
emeute=émeute
emigre=émigré
eminence grise=éminence grise
enarque=énarque
engagee=engagée
entrecote=entrecôte
entree=entrée
entrepot=entrepôt
epee=épée
epeeist=épéeist
epopee=épopée
etagere=étagère
etatisme=étatisme
etoile=étoile
etouffee=étouffée
etrier=étrier
etude=étude
etui=étui
an expose=an exposé
facade=façade
faconne=façonné
faineant=fainéant
fainne=fáinne
faux-naif=faux-naïf
facon de parler=façon de parler
feerie=féerie
fete=fête
fete champetre=fête champêtre
fiance=fiancé
fiancee=fiancée
gumbo file=gumbo filé
file powder=filé powder
fin de siecle=fin de siècle
fixed head coupe=fixed head coupé
flambe=flambé
flambeed=flambéed
flambeing=flambéing
flambes=flambés
flanerie=flânerie
flaneur=flâneur
fleche=flèche
flechette=fléchette
flugelhorn=flügelhorn
folie a deux=folie à deux
fouette=fouetté
frappe=frappé
frise=frisé
garcon=garçon
gateau=gâteau
gateaux=gâteaux
# gateau is very withspread. May be reconsidered.
gemutlich=gemütlich
giclee=giclée
gite=gîte
glace=glacé
grunerite=grünerite
guarani=guaraní
habitue=habitué
hacek=háček
hao=hào
hauyne=haüyne
heroon=herõon
hubnerite=hübnerite
idee=idée
idee recue=idée reçue
idee fixe=idée fixe
ingenue=ingénue
jalapeno=jalapeño
jardiniere=jardinière
jaspe=jaspé
jefe politico=jefe político
jete=jeté
jeunesse doree=jeunesse dorée
jo=jō
jokulhlaup=jökulhlaup
kamancha=kamāncha
kamanche=kamānche
kavya=kāvya
krona=króna
kronur=krónur
lagerstatte=lagerstätte
lapsus linguae=lapsūs linguae
lese majeste=lèse majesté
limacon=limaçon
lollingite=löllingite
macedoine=macédoine
macrame=macramé
madrilene=madrilène
madrono=madroño
maelstrom=maelström
maison de tolerance=maison de tolérance
maitre d'=maître d'
maitre d'hotel=maître d'hôtel
malpais=malpaís
manana=mañana
mandala=maṇḍala
manege=manège
manque=manqué
moules marinieres=moules marinières
marron glace=marron glacé
marrons glaces=marrons glacés
martele=martelé
# masse=massé
materiel=matériel
matinee=matinée
matinee idol=matinée idol
melange=mélange
# melee=mêlée
menage=ménage
menage a trois=ménage à trois
meningocele manque=meningocele manqué
mesalliance=mésalliance
methode champenoise=méthode champenoise
metier=métier
meuniere=meunière
mezair=mézair
military attache=military attaché
mise en scene=mise en scène
misere=misère
misere ouvert=misère ouvert
moire=moiré
moire pattern=moiré pattern
mokki=mökki
mongo=möngö
mouille=mouillé
mousme=mousmé
mousmee=mousmée
mouton enrage=mouton enragé
mudra=mudrā
mujtahidun=mujtahidūn
mumak=mûmak
musique concrete=musique concrète
naga=nāga
naif=naïf
naiveness=naïveness
naivete=naïveté
# naivete=naiveté
naivete=naïvete
naivety=naïvety
# 'naive.+' are very withspread. May be reconsidered.
ne=né
nee=née
negligee=négligée
negligee=negligée
neve=névé
norteno=norteño
noel=noël
nuee ardente=nuée ardente
numeraire=numéraire
objet trouve=objet trouvé
ole=olé
omerta=omertà
opera bouffe=opéra bouffe
opera comique=opéra comique
orne=orné
outre=outré
pandit=paṇḍit
papier-mache=papier-mâché
parc ferme=parc fermé
passe=passé
pate=pâté
pate brisee=pâte brisée
pate de foie gras=pâté de foie gras
patisserie=pâtisserie
pave=pavé
pengo=pengő
pere=père
perestroika=perestroĭka
petanque=pétanque
petillant=pétillant
phosphorrosslerite=phosphorrösslerite
piece de resistance=pièce de résistance
piece montee=pièce montée
pied-a-terre=pied-à-terre
pieds-a-terre=pieds-à-terre
pieta=pietà
pina colada=piña colada
pinata=piñata
pinon=piñon
pique=piqué
pise=pisé
piu=più
plie=plié
plisse=plissé
plus ca change=plus ça change
pointille=pointillé
porte cochere=porte cochère
portiere=portière
pousse-cafe=pousse-café
precis=précis
premiere=première
# 'premiere' is very withspread. May be reconsidered.
premiere danseuse=première danseuse
proces-verbal=procès-verbal
protege=protégé
protege=protegé
protegee=protégée
puree=purée
qanat=qanāt
qasida=qaṣīda
qindarke=qindarkë
quinceanera=quinceañera
quoi ci quoi ca=quoi ci quoi ça
rai=raï
raison d'etre=raison d'être
rastaquouere=rastaquouère
rechauffe=réchauffé
recherche=recherché
regime=régime
regisseur=régisseur
remoulade=rémoulade
repechage=repêchage
repetiteur=répétiteur
repousse=repoussé
retrousse=retroussé
rincon=rincón
risque=risqué
roman a clef=roman à clef
roman a these=roman à thèse
romanechite=romanèchite
rontgen=röntgen
rose wine=rosé wine
roue=roué
sacre bleu=sacré bleu
saignee=saignée
sake bomb=saké bomb
of|a sake=\0 saké
salade nicoise=salade niçoise
salchichon=salchichón
samsara=saṃsāra
sate=saté
saute=sauté
sauteed=sautéed
sauteing=sautéing
schrockingerite=schröckingerite
seance=séance
seme=semé
senor=señor
senora=señora
senorita=señorita
sharif=sharīf
shonen=shōnen
smriti=smṛiti
soigne=soigné
soignee=soignée
soiree=soirée
solfege=solfège
son et lumiere=son et lumière
souffle=soufflé
soule=soulé
soupcon=soupçon
sprachgefuhl=sprachgefühl
sutra=sūtra
table d'hote=table d'hôte
takahe=takahē
taqueria=taquería
tete-a-tete=tête-à-tête
tete-beche=tête-bêche
togrog=tögrög
tomato puree=tomato purée
touche=touché
transport cafe=transport café
tres chic=très chic
trouvere=trouvère
ubermensch=übermensch
udatta=udātta
ulvospinel=ulvöspinel
uropoiesis=uropoïesis
veloute=velouté
vicuna=vicuña
vis-a-vis=vis-à-vis
vive la difference=vive la différence
voila=voilà
volva=völva
vrddhied=vṛddhied
whereas=whereäs
wustite=wüstite
zaire=zaïre
zalesiite=zálesíite
zoea=zoëa

