# Redundancies database
# List converted from AtD
#
12 noon=noon
# 12 o'clock noon=noon
# a.m. in the morning=a.m.
# ABS brakes=ABS
# ABS braking system=ABS
absolute guarantee=guarantee
absolutely essential=essential
absolutely necessary=necessary
absolutely sure=sure
ACT test=ACT
actual experience=experience
actual facts=facts
add a further=add
add an additional=add
added bonus=bonus
# add up=add
advance forward=advance
advance planning=planning
advance preview=preview
advance reservations=reservations
advance warning=warning
affirmative yes=yes
aid and abet=abet
# all inclusive=inclusive
# all of=all
all-time record=record
alongside of=alongside
# alongside=side
alternative choice=alternative
always and forever=always
amaretto almond=amaretto
# a.m. in the morning=a.m.
and etc=etc
annual anniversary=anniversary
anonymous stranger=stranger
a pair of twins=twins
armed gunman=gunman
armed gunmen=gunmen
artificial prosthesis=prosthesis
ascend up=ascend
as for example=for example
ask the question=ask
as per=per
assemble together=assemble
as to whether=whether
at a later date=at
attach together=attach
at the present time=now
at this point in time=at this point
autumn season=autumn
awful bad=bad
# bald-headed=bald
balsa wood=balsa
bare naked=naked
basic fundamentals=fundamentals
basic necessities=necessities
bento box=bento
best ever=best
blend together=blend
boat marina=marina
# Bo Staff=Bo
bouquet of flowers=bouquet
brief cameo=cameo
brief in duration=brief
brief moment=moment
brief summary=summary
bruin bear=bruin
burning embers=embers
burning hot=burning
but however=but
but nevertheless=but
cacophony of sound=cacophony
cameo appearance=cameo
cancel out=cancel
careful scrutiny=scrutiny
cash money=cash
CD Disc=CD
CD disc=CD
cease and desist=cease
chai tea=chai
circle around=circle
circulate around=circulate
classify into groups=classify
climb up=climb
closed fist=fist
close proximity=proximity
close scrutiny=scrutiny
collaborate together=collaborate
combine together=combine
common bond=bond
commute back and forth=commute
compete with each other=compete
completely annihilate=annihilate
completely destroyed=destroyed
completely eliminate=eliminate
completely engulfed=engulfed
completely filled=filled
completely surround=surround
complete monopoly=monopoly
component parts=parts
comprises of=comprises
confer together=confer
confused state=confused
connect together=connect
connect up=connect
consensus of opinion=consensus
constantly maintained=maintained
consult with=consult
continue to remain=remain
cool down=cool
cooperate together=cooperate
cost the sum of=cost
could possibly=could
crisis situation=crisis
crouch down=crouch
curative process=curative
current trend=trend
dates back=dates
definite decision=decision
depreciate in value=depreciate
descend down=descend
desirable benefits=benefits
different kinds=kinds
difficult dilemma=dilemma
direct confrontation=confrontation
disappear from sight=disappear
dive down=dive
# downward=ward
drop down=drop
duplicate copy=copy
during the course of=during
dwindled down=dwindled
dwindle down=dwindle
dynamic range=range
each and every=each
earlier in time=earlier
eliminate altogether=eliminate
emergency situation=emergency
empty hole=hole
empty out=empty
empty space=space
enclosed herein=enclosed
end result=result
enter in=enter
enter into=enter
entirely eliminate=eliminate
equally as=as
equal to one another=equal
eradicate completely=eradicate
established fact=fact
estimated at about=estimated at
estimated at approximately=estimated at
estimated at around=estimated at
every now and then=now and then
evolve over time=evolve
exact opposites=opposites
exact replica=replica
exact same=same
exited from=exited
exposed opening=opening
extra bonus=bonus
extradite back=extradite
face mask=mask
face up to=face
facilitate easier=facilitate
fall down=fall
fall season=fall
false pretenses=pretenses
favorable approval =approval 
feel inside=feel
fellow classmates=classmates
fellow colleague=colleague
few in number=few
filled to capacity=filled
final conclusion=conclusion
final end=end
final outcome=outcome
final ultimatum=ultimatum
financial accounting=accounting
first and foremost=foremost
first began=began
first conceived=conceived
first of all=first
first started=started
first time ever=first time
fit enough=fit
fly through the air=fly
focus in=focus
follow after=follow
foreign imports=imports
forever and ever=forever
for free=free
former graduate=graduate
former veteran=veteran
forward planning=planning
free gift=gift
free gifts=gifts
free pass=pass
from whence=whence
frozen ice=ice
frozen tundra=tundra
full satisfaction=satisfaction
full to capacity=full
fuse together=fuse
future plans=plans
future recurrence=recurrence
gather together=gather
gather up=gather
general consensus=consensus
general public=public
get up on his feet=get up
get up on your feet=get up
glowing ember=ember
GOP party=GOP
GRE exam=GRE
grow in size=grow
had done previously=had done
# Hallah bread=Hallah
hard facts=facts
harmful injuries=injuries
has got=got
have got=have
head honcho=honcho
heat up=heat
he himself=he
highly relevant=relevant
high noon=noon
high time=time
HIV virus=HIV
hoist up=hoist
hollow tube=tube
honest truth=truth
hot water heater=water heater
hurry up=hurry
illustrated drawing=drawing
I myself=I
in actual fact=actual
incredible to believe=incredible
indicted on a charge=indicted
indicted on a charge of=on a charge
inner core=core
inner feelings=feelings
innovative new=innovative
in order to=to
input into=input
integral part of=part of
integrate together=integrate
integrate with each other=integrate
# interconnected=inter
interdependent on each other=interdependent
introduced a new=introduced a
introduced for the first time=introduced
inward into=into
# inward=ward
in which we live in=in which we live
I personally=I
# irregardless=regardless
ISBN number=ISBN
# It is what it is=It is
joint collaboration=collaboration
join together=join
just recently=recently
kneel down=kneel
knots per hour=knots
knowledgeable experts=experts
lag behind=lag
last of all=last
later time=later
LCD display=LCD
left behind=left
# leftward=ward
lift up=lift
linger on=linger
little baby=baby
live studio audience=studio audience
live witness=witness
local residents=residents
look ahead to the future=look to the future
lose out on=lose
made out of=made of
main focus=focus
major breakthrough=breakthrough
major feat=feat
manually by hand=manually
# many different=many
mass media=media
may possibly=may
meet together=meet
meet up=meet
meet with each other=meet
mental telepathy=telepathy
merged together=merged
merge together=merge
meshed together=meshed
midway between=midway
might possibly=might
migraine headache=migraine
Milky Way galaxy=Milky Way
minestrone soup=minestrone
miss out on=miss
mix together=mix
moment in time=moment
money-saving coupon=coupon
# Mount Fujiyama=Fujiyama
mutual cooperation=cooperation
mutually dependent on each other=mutually dependent
mutually interdependent=interdependent
mutual respect for each other=mutual respect
nape of her neck=nape
native habitat=habitat
natural instinct=instinct
naturally instinct=instinct
necessary requirements=requirements
never at any time=never
never before=never
new beginning=beginning
new bride=bride
new construction=construction
new innovation=innovation
new innovative=innovative
new invention=invention
new record=record
new recruit=recruit
none at all=none
nostalgia for the past=nostalgia
now currently=currently
now pending=pending
null and void=void
number of different=number of
off in the distance=in the distance
old adage=adage
old cliche=cliche
old custom=custom
old pioneer=pioneer
old proverb=proverb
one and the same=the same
# onto=to|on
# onward=ward
open trench=trench
open up=open
oral conversation=conversation
or alternatively=or
orbits around=orbits
originally created=created
originally discovered=discovered
output out of=output
outside in the yard=in the yard
outside of=outside
# outward=ward
over and done with=over with
over and over again=over and over
over exaggerate=exaggerate
over top of=over
over top=over
overused cliche=cliche
over with=over
pair of twins=twins
palm of the hand=palm
passing fad=fad
past experience=experience
past history=history
past memories=memories
past records=records
PC computer=PC
peace and quiet=quiet
penetrate into=penetrate
penetrate through=penetrate
perfect ideal=ideal
period of time= of time
personal belongings=belongings
personal charm=charm
personal friend=friend
personal friendship=friendship
personal opinion=opinion
per usual=usual
pick and choose=pick
PIN number=PIN
pitch black=black
pizza pie=pizza
plan ahead=plan
plan in advance=plan
Please RSVP=RSVP
please RSVP=RSVP
plunge down=plunge
point in time=point
polar opposites=opposites
positive identification=identification
postpone until later=postpone
pouring down rain=down
precise same=same
present incumbent=incumbent
present time=present
previously listed above=previously listed
private industry=industry
probed into=probed
proceed ahead=proceed
proposed plan=plan
protest against=protest
protrude out=protrude
pursue after=pursue
put off until later=put off
raise up=raise
RAM memory=RAM
random chance=chance
rate of speed=speed
really unique=unique
reason is because=reason is
reason why=reason
recur again=recur
re-elect for another term=re-elect
refer back=refer
reflect back=reflect
regular routine=routine
repeat again=repeat
reply back=reply
retreat back=retreat
revert back=revert
right now=now
right over=over
# rightward=ward
Rio Grande River=Rio Grande
Rio Grande river=Rio Grande
rise up=rise
rough rule of thumb=rule of thumb
round circle=circle
round in shape=round
rustic country=rustic
safe haven=haven
safe sanctuary=sanctuary
same exact=same
same identical=identical
sand dune=dune
SAT test=SAT
scrutinize in detail=scrutinize
secret that cannot be told= that cannot be told
seek out=seek
seek to find=seek
separated apart from each other=separated
serious danger=danger
share together=share
sharp point=point
shiny in appearance=shiny
short summary=summary
shut down=shut
single unit=unit
sink down=sink
situated in=in
skipped over=skipped
slow speed=slow
small size=small
small speck=speck
soaked to the skin=soaked
# so as to=to
soda pop=soda
soft in texture=soft
soft to the touch=soft
sole of the foot=sole
some time to come=some time
somewhat unique=unique
so therefore=so
specific details=details
spell out in detail=spell out
spiked upwards=upwards
spiked upward=upward
spliced together=spliced
spring season=spring
stacked together=stacked
start off=start
start out=start
starts out=starts
started out=started
State of New Mexico=New Mexico
State of New York=New York
State of North Carolina=North Carolina
State of North Dakota=North Dakota
State of South Carolona=South Carolona
State of South Dakota=South Dakota
still lingers=lingers
still persists=persists
still remains=remains
subject matter=subject
sudden impulse=impulse
sufficient enough=sufficient
summer season=summer
sum total=total
surrounded on all sides=surrounded
swoop down=swoop
talking out loud=talking
tall in height=tall
tall in stature=tall
tear apart=tear
temper tantrum=tantrum
temporary reprieve=reprieve
ten in number=ten
teriyaki barbecue=teriyaki
therapeutic treatment=treatment
these ones=these
they themselves=they
thorough investigation=investigation
those ones=those
three-way love triangle=love triangle
time clock=clock
time period=period
tiny bit=bit
to ask a question=to ask
to ask for assistance=to ask
to ask for help=to ask
together at the same time=together
total destruction=destruction
totally destroy=destroy
totally unique=unique
true facts=facts
truly sincere=sincere
tuna fish=tuna
twelve midnight=midnight
twelve noon=noon
two equal halves=halves
ultimate goal=goal
unconfirmed rumor=rumor
undeniable truth=undeniable
undergraduate student=undergraduate
underground subway=subway
unexpected emergency=emergency
unexpected surprise=surprise
unintentional mistake=unintentional
universal panacea=panacea
unnamed anonymous=anonymous
unsolved mystery=mystery
UPC code=UPC
# up on top of=on top of
up on top=on top
# upward=ward
usual custom=custom
vacillate back and forth=vacillate
veiled ambush=ambush
very pregnant=pregnant
very unique=unique
visible to the eye=visible
wall mural=mural
warm up=warm
warn in advance=warn
weather conditions=weather
weather situation=weather
we ourselves=we
whether or not=whether
white snow=snow
# why come=why
winter season=winter
write down=write
written down=written
yakitori chicken=yakitori
yerba mate tea=yerba mate

