a	a	DT
aboard	aboard	IN
aboard	aboard	RP
about	about	IN
about	about	RP
above	above	IN
absent	absent	IN
across	across	IN
across	across	RP
after	after	IN
against	against	IN
ago	ago	IN
all	all	DT
all	all	PDT
along	along	IN
along	along	RP
alongside	alongside	IN
am	be	VBP
amid	amid	IN
amidst	amidst	IN
among	among	IN
amongst	amongst	IN
an	a	DT
and	and	CC
another	another	DT
any	any	DT
apart	apart	RP
are	be	VBP
around	around	IN
around	around	RP
art	be	VBP
as	as	IN
aside	aside	RP
at	at	IN
at	at	RP
atop	atop	IN
away	away	RP
back	back	RP
be	be	VB
been	be	VBN
before	before	IN
before	before	RP
behind	behind	IN
behind	behind	RP
being	be	VBG
below	below	IN
beneath	beneath	IN
beside	beside	IN
besides	besides	IN
between	between	IN
beyond	beyond	IN
billion	billion	CD
both	both	CC
both	both	DT
both	both	PDT
but	but	CC
by	by	IN
by	by	RP
can	can	MD
cannot	can	MD
cannot	cannot	MD
could	can	MD
could	could	MD
couldn	couldn't	MD
crop	crop	RP
dare	dare	MD
despite	despite	IN
doesn	do	VBZ
down	down	IN
down	down	RP
during	during	IN
each	each	DT
eight		eight	CD
eighteen	eighteen	CD
eighty	eighty	CD
either	either	CC
either	either	DT
eleven	eleven	CD
et	et	CC
ever	ever	RP
every	every	DT
except	except	IN
fast	fast	RP
fifteen	fifteen	CD
fifty	fifty	CD
five	five	CD
following	following	IN
for	for	CC
for	for	IN
for	for	RP
forth	forth	RP
forty	forty	CD
four	four	CD
fourteen	fourteen	CD
from	from	IN
from	from	RP
go	go	RP
half	half	DT
half	half	PDT
hasn	have	VBZ
haven	have	VBP
he	he	PRP
her	her	PRP$
her	she	PRP
hers	her	PRP
herself	she	PRP
high	high	RP
him	he	PRP
himself	he	PRP
his	his	PRP$
hisself	he	PRP
how	how	WRB
however	however	WRB
hundred	hundred	CD
i.e.	i.e.	RP
in	in	IN
in	in	RP
inside	inside	IN
into	into	IN
into	into	RP
is	be	VBZ
it	it	PRP
its	its	PRP$
itself	it	PRP
just	just	RP
la	la	DT
later	later	RP
less	less	CC
like	like	IN
low	low	RP
many	half	PDT
many	many	DT
may	may	MD
me	I	PRP
mid	mid	IN
might	might	MD
million	million	CD
mine	mine	PRP$
minus	minus	CC
minus	minus	IN
more	more	RP
most	much	RBS
much	much	DT
musn	must	VBZ
must	must	MD
my	my	PRP$
myself	I	PRP	
nary	nary	DT
near	near	IN
nearest	nearest	IN
need	need	MD
needn	need	VBZ
neither	neither	CC
neither	neither	DT
nine	nine	CD
nineteen	nineteen	CD
ninety	ninety	CD
no	no	DT
nor	nor	CC
notwithstanding	notwithstanding	IN
of	of	IN
off	off	IN
off	off	RP
on	on	IN
on	on	RP
one	one	CD
one	one	PRP
oneself	one	PRP
onto	onto	IN
open	open	RP
opposite	opposite	IN
or	or	CC
ought	ought	MD
our	our	PRP$
ours	ours	PRP$
ours	we	PRP
ourselves	we	PRP
out	out	IN
out	out	RP
outside	outside	IN
over	over	IN
over	over	RP
ownself	ownself	PRP
past	past	IN
per	per	RP
pie	pie	RP
plus	plus	CC
quite	half	PDT
raising	raising	RP
re	re	IN
round	round	IN
self	self	PRP
seven	seven	CD
seventeen	seventeen	CD
seventy	seventy	CD
shall	shall	MD
she	she	PRP
should	should	MD
shouldn	shall	MD
shouldn	shouldn't	MD
since	since	IN
six	six	CD
sixteen	sixteen	CD
sixty	sixty	CD
so	so	CC
some	some	DT
start	start	RP
such	such	DT
such	such	PDT
sure	sure	PDT
t	t	RB
teeth	teeth	RP
ten	ten	CD
than	than	IN
that	that	DT
that	that	RP
that	that	WDT
that	that	WP
the	the	DT
thee	you	PRP
their	their	PRP$
theirs	they	PRP
them	they	DT
them	they	PRP
themselves	they	PRP
there	there	EX
there	there	RB
therefore	therefore	CC
these	these	DT
they	they	PRP
thirteen	thirteen	CD
thirty	thirty	CD
thirty-one	thirty-one	CD
this	this	DT
this	this	PDT
those	those	DT
thou	you	PRP
thousand	thousand	CD
three	three	CD
through	through	IN
through	through	RP
throughout	throughout	IN
thy	you	PRP
till	till	IN
times	times	CC
to	to	IN
to	to	TO
toward	toward	IN
towards	towards	IN
trillion	trillion	CD
twelve	twelve	CD
twenty	twenty	CD
twenty-eight	twenty-eight	CD
twenty-five	twenty-five	CD
twenty-four	twenty-four	CD
twenty-nine	twenty-nine	CD
twenty-one	twenty-one	CD
twenty-seven	twenty-seven	CD
twenty-six	twenty-six	CD
twenty-three	twenty-three	CD
twenty-two	twenty-two	CD
two	two	CD
under	under	IN
under	under	RP
underneath	underneath	IN
unlike	unlike	IN
until	until	IN
unto	unto	RP
up	up	IN
up	up	RP
up-pp	up-pp	RP
upon	upon	IN
upon	upon	RP
us	we	PRP
v	versus	CC
versus	versus CC
via	via	IN
vs	versus	CC
was	be	VBD
wast	be	VBD
were	be	VBD
what	what	WDT
what	what	WP
whatever	whatever	WDT
whatever	whatever	WP
whatsoever	whatsoever	WP
whence	whence	WRB
whenever	whenever	WRB
where	where	WRB
whereby	whereby	WRB
whereever	whereever	WRB
wherein	wherein	WRB
whereof	whereof	WRB
wherever	wherever	WRB
whether	whether CC
which	which	WDT
which	which	WP
whichever	whichever	WDT
who	who	WP
whoever	whoever	WP
whole	whole	RP
whom	who	WP
whom	whom	WP
whose	whose	WP$
whosoever	whosoever	WP 
why	why	WRB
will	will	MD
with	with	IN
with	with	RP
with	with	IN
within	within	IN
without	without	IN
would	would	MD
wouldn	will	MD
yet	yet	CC
you	you	PRP
you	you	RP
your	your	PRP$
