# A part-of-speech dictionary that's used additionally to the binary dictionary (*.dict).
# This does not add words to the spell checker, see hunspell/spelling.txt for that.
# File Encoding: UTF-8
# Format: three tab-separated fields: fullform baseform postags
about	about	RB
accessorise	accessorise	VB
accessorise	accessorise	VBP
accessorised	accessorise	VBD
accessorised	accessorise	VBN
accessorises	accessorise	VBZ
accessorising	accessorise	VBG
accessorize	accessorize	VB
accessorize	accessorize	VBP
accessorized	accessorize	VBD
accessorized	accessorize	VBN
accessorizes	accessorize	VBZ
accessorizing	accessorize	VBG
action	action	VB
action	action	VBP
actioning	action	VBG
actions	action	VBZ
adhesion	adhesion	NN:UN
advancing	advancing	JJ
aggravating	aggravating	JJ
air	air	NN
air-dry	air-dry	JJ
airpower	airpower	NN:UN
alchemise	alchemise	VB
alchemise	alchemise	VBP
alchemised	alchemise	VBD
alchemised	alchemise	VBN
alchemises	alchemise	VBZ
alchemising	alchemise	VBG
alcoholise	alcoholise	VB
alcoholise	alcoholise	VBP
alcoholised	alcoholise	VBD
alcoholised	alcoholise	VBN
alcoholises	alcoholise	VBZ
alcoholising	alcoholise	VBG
Aldiss	Aldiss	NNP
allegorise	allegorise	VB
allegorise	allegorise	VBP
allegorised	allegorise	VBD
allegorised	allegorise	VBN
allegorises	allegorise	VBZ
Allerdale	Allerdale	NNP
anglicisation	anglicisation	NN:UN
anglicisations	anglicisation	NNS
ångström	ångström	NN
ångströms	ångström	NNS
anodisation	anodisation	NN:UN
anodisations	anodisation	NNS
anthropologise	anthropologise	VB
anthropologise	anthropologise	VBP
anthropologised	anthropologise	VBD
anthropologised	anthropologise	VBN
anthropologises	anthropologise	VBZ
anthropologising	anthropologise	VBG
anthropologize	anthropologize	VB
anthropologize	anthropologize	VBP
anthropologized	anthropologize	VBD
anthropologized	anthropologize	VBN
anthropologizes	anthropologize	VBZ
anthropologizing	anthropologize	VBG
anthropomorphise	anthropomorphise	VB
anthropomorphise	anthropomorphise	VBP
anthropomorphised	anthropomorphise	VBD
anthropomorphised	anthropomorphise	VBN
anthropomorphises	anthropomorphise	VBZ
antihermitian	antihermitian	JJ
antilinear	antilinear	JJ
apotheosise	apotheosise	VB
apotheosise	apotheosise	VBP
apotheosised	apotheosise	VBD
apotheosised	apotheosise	VBN
apotheosises	apotheosise	VBZ
apotheosising	apotheosise	VBG
appetising	appetising	JJ
approval	approval	NN
approving	approving	JJ
APRIL	April	NNP
aromatise	aromatise	VB
aromatise	aromatise	VBP
aromatised	aromatise	VBD
aromatised	aromatise	VBN
aromatises	aromatise	VBZ
aromatising	aromatise	VBG
attoampere	attoampere	NN
attoamperes	attoampere	NNS
attobecquerel	attobecquerel	NN
attobecquerels	attobecquerel	NNS
attocandela	attocandela	NN
attocandelas	attocandela	NNS
attocoulomb	attocoulomb	NN
attocoulombs	attocoulomb	NNS
attofarad	attofarad	NN
attofarads	attofarad	NNS
attogram	attogram	NN
attogramme	attogramme	NN
attogrammes	attogramme	NNS
attograms	attogram	NNS
attogray	attogray	NN
attograys	attogray	NNS
attohenries	attohenry	NNS
attohenry	attohenry	NN
attohertz	attohertz	NN
attohertz	attohertz	NNS
attojoule	attojoule	NN
attojoules	attojoule	NNS
attokatal	attokatal	NN
attokatals	attokatal	NNS
attokelvin	attokelvin	NN
attokelvins	attokelvin	NNS
attoliter	attoliter	NN
attoliters	attoliter	NNS
attolitre	attolitre	NN
attolitres	attolitre	NNS
attolumen	attolumen	NN
attolumens	attolumen	NNS
attolux	attolux	NN
attolux	attolux	NNS
attometer	attometer	NN
attometers	attometer	NNS
attometre	attometre	NN
attometres	attometre	NNS
attomole	attomole	NN
attomoles	attomole	NNS
attonewton	attonewton	NN
attonewtons	attonewton	NNS
attoohm	attoohm	NN
attoohms	attoohm	NNS
attopascal	attopascal	NN
attopascals	attopascal	NNS
attoradian	attoradian	NN
attoradians	attoradian	NNS
attosiemens	attosiemens	NN
attosiemens	attosiemens	NNS
attosievert	attosievert	NN
attosieverts	attosievert	NNS
attosteradian	attosteradian	NN
attosteradians	attosteradian	NNS
attotesla	attotesla	NN
attoteslas	attotesla	NNS
attovolt	attovolt	NN
attovolts	attovolt	NNS
attowatt	attowatt	NN
attowatts	attowatt	NNS
attoweber	attoweber	NN
attowebers	attoweber	NNS
AUGUST	August	NNP
automagically	automagically	RB
autorotate	autorotate	VB
autorotate	autorotate	VBP
autorotated	autorotate	VBD
autorotated	autorotate	VBN
autorotates	autorotate	VBZ
autorotating	autorotate	VBG
bachelorette	bachelorette	NN
bachelorettes	bachelorette	NNS
bariatric	bariatric	JJ
bellcrank	bellcrank	NN
bellcranks	bellcrank	NNS
bereaved	bereaved	JJ
Betts	Betts	NNP
bitesized	bitesized	JJ
bituminise	bituminise	VB
bituminise	bituminise	VBP
bituminised	bituminise	VBD
bituminised	bituminise	VBN
bituminises	bituminise	VBZ
bituminising	bituminise	VBG
blockchain	blockchain	NN
blockchains	blockchain	NNS
bloggers	blogger	NNS
Bluetooth	Bluetooth	NNP
boomset	boomset	NN
boomsets	boomset	NNS
boomtown	boomtown	NN
boomtowns	boomtown	NNS
botnet	botnet	NN
botnets	botnet	NN
Brexit	Brexit	NNP
Bridgend	Bridgend	NNP
Bridgnorth	Bridgnorth	NNP
Brissette	Brissette	NNP
Broxbourne	Broxbourne	NNP
budding	budding	JJ
bunkered	bunker	VBD
bunkered	bunker	VBN
bunkering	bunker	VBG
burglarise	burglarise	VB
burglarise	burglarise	VBP
burglarised	burglarise	VBD
burglarised	burglarise	VBN
burglarises	burglarise	VBZ
burglarising	burglarise	VBG
callouts	callout	NNS
cancellable	cancellable	JJ
cannibalisation	cannibalisation	NN:UN
carburise	carburise	VB
carburise	carburise	VBP
carburised	carburise	VBD
carburised	carburise	VBN
carburises	carburise	VBZ
carburising	carburise	VBG
catabolise	catabolise	VB
catabolise	catabolise	VBP
catabolised	catabolise	VBD
catabolised	catabolise	VBN
catabolises	catabolise	VBZ
catabolising	catabolise	VBG
catalyse	catalyse	VB
catalyse	catalyse	VBP
catalysed	catalyse	VBD
catalysed	catalyse	VBN
catalyses	catalyse	VBZ
catalysing	catalyse	VBG
catastrophise	catastrophise	VB
catastrophise	catastrophise	VBP
catastrophised	catastrophise	VBD
catastrophised	catastrophise	VBN
catastrophises	catastrophise	VBZ
catastrophising	catastrophise	VBG
catastrophize	catastrophize	VB
catastrophize	catastrophize	VBP
catastrophized	catastrophize	VBD
catastrophized	catastrophize	VBN
catastrophizes	catastrophize	VBZ
catastrophizing	catastrophize	VBG
celiac	celiac	JJ
centiampere	centiampere	NN
centiamperes	centiampere	NNS
centibecquerel	centibecquerel	NN
centibecquerels	centibecquerel	NNS
centicandela	centicandela	NN
centicandelas	centicandela	NNS
centicoulomb	centicoulomb	NN
centicoulombs	centicoulomb	NNS
centifarad	centifarad	NN
centifarads	centifarad	NNS
centigray	centigray	NN
centigrays	centigray	NNS
centihenries	centihenry	NNS
centihenry	centihenry	NN
centihertz	centihertz	NN
centihertz	centihertz	NNS
centijoule	centijoule	NN
centijoules	centijoule	NNS
centikatal	centikatal	NN
centikatals	centikatal	NNS
centikelvin	centikelvin	NN
centikelvins	centikelvin	NNS
centilumen	centilumen	NN
centilumens	centilumen	NNS
centilux	centilux	NN
centilux	centilux	NNS
centimole	centimole	NN
centimoles	centimole	NNS
centinewton	centinewton	NN
centinewtons	centinewton	NNS
centiohm	centiohm	NN
centiohms	centiohm	NNS
centipascal	centipascal	NN
centipascals	centipascal	NNS
centiradian	centiradian	NN
centiradians	centiradian	NNS
centisiemens	centisiemens	NN
centisiemens	centisiemens	NNS
centisievert	centisievert	NN
centisieverts	centisievert	NNS
centisteradian	centisteradian	NN
centisteradians	centisteradian	NNS
centitesla	centitesla	NN
centiteslas	centitesla	NNS
centivolt	centivolt	NN
centivolts	centivolt	NNS
centiwatt	centiwatt	NN
centiwatts	centiwatt	NNS
centiweber	centiweber	NN
centiwebers	centiweber	NNS
centreline	centreline	NN
centrelines	centreline	NNS
Ceredigion	Ceredigion	NNP
chatbot	chatbot	NN
chatbots	chatbot	NNS
checkbox	checkbox	NN
checkboxes	checkbox	NNS
chemoprophylactic	chemoprophylactic	JJ
Cherkasy	Cherkasy	NNP
Chernihiv	Chernihiv	NNP
Chernivtsi	Chernivtsi	NNP
chloracne	chloracne	NN:U
cicatrise	cicatrise	VB
cicatrise	cicatrise	VBP
cicatrised	cicatrise	VBD
cicatrised	cicatrise	VBN
cicatrises	cicatrise	VBZ
cicatrising	cicatrise	VBG
civilianise	civilianise	VB
civilianise	civilianise	VBP
civilianised	civilianise	VBD
civilianised	civilianise	VBN
civilianises	civilianise	VBZ
civilianising	civilianise	VBG
civilianize	civilianize	VB
civilianize	civilianize	VBP
civilianized	civilianize	VBD
civilianized	civilianize	VBN
civilianizes	civilianize	VBZ
civilianizing	civilianize	VBG
cloth	cloth	NN
coding	coding	NN:UN
codings	coding	NNS
collateralise	collateralise	VB
collateralise	collateralise	VBP
collateralised	collateralise	VBD
collateralised	collateralise	VBN
collateralises	collateralise	VBZ
collateralising	collateralise	VBG
collateralize	collateralize	VB
collateralize	collateralize	VBP
collateralized	collateralize	VBD
collateralized	collateralize	VBN
collateralizes	collateralize	VBZ
collateralizing	collateralize	VBG
colourisation	colourisation	NN:U
colourization	colourization	NN:UN
colourize	colourize	VB
colourize	colourize	VBP
colourized	colourize	VBD
colourized	colourize	VBN
colourizes	colourize	VBZ
colourizing	colourize	VBG
comingle	comingle	VB
comingle	comingle	VBP
comingled	comingle	VBD
comingled	comingle	VBN
comingles	comingle	VBZ
comingling	comingle	VBG
commodified	commodify	VBD
commodified	commodify	VBN
commodifies	commodify	VBZ
commodify	commodify	VB
commodify	commodify	VBP
commodifying	commodify	VBG
commoditise	commoditise	VB
commoditise	commoditise	VBP
commoditised	commoditise	VBD
commoditised	commoditise	VBN
commoditises	commoditise	VBZ
commoditising	commoditise	VBG
commoditize	commoditize	VB
commoditize	commoditize	VBP
commoditized	commoditize	VBD
commoditized	commoditize	VBN
commoditizes	commoditize	VBZ
commoditizing	commoditize	VBG
competing	competing	JJ
componentisation	componentisation	NN:U
componentization	componentization	NN:U
computerisation	computerisation	NN:U
concerning	concerning	IN
Congleton	Congleton	NNP
conscientise	conscientise	VB
conscientise	conscientise	VBP
conscientised	conscientise	VBD
conscientised	conscientise	VBN
conscientises	conscientise	VBZ
conscientising	conscientise	VBG
conscientize	conscientize	VB
conscientize	conscientize	VBP
conscientized	conscientize	VBD
conscientized	conscientize	VBN
conscientizes	conscientize	VBZ
conscientizing	conscientize	VBG
constitutionalise	constitutionalise	VB
constitutionalise	constitutionalise	VBP
constitutionalised	constitutionalise	VBD
constitutionalised	constitutionalise	VBN
constitutionalises	constitutionalise	VBZ
constitutionalising	constitutionalise	VBG
contextualisation	contextualisation	NN:UN
contextuality	contextuality	NN:U
Coon	Coon	NNP
co-pilot	co-pilot	NN
co-pilots	co-pilot	NNS
corporatise	corporatise	VB
corporatise	corporatise	VBP
corporatised	corporatise	VBD
corporatised	corporatise	VBN
corporatises	corporatise	VBZ
corporatising	corporatise	VBG
corporatize	corporatize	VB
corporatize	corporatize	VBP
corporatized	corporatize	VBD
corporatized	corporatize	VBN
corporatizes	corporatize	VBZ
corporatizing	corporatize	VBG
cough	cough	NN
counter-clockwise	counter-clockwise	JJ
coupé	coupé	NN
coupés	coupé	NNS
criminalisation	criminalisation	NN:UN
curveball	curveball	NN
curveballs	curveball	NNS
cutout	cutout	NN
cutouts	cutout	NNS
damaging	damaging	JJ
deaerate	deaerate	VB
deaerated	deaerate	VBD
deaerated	deaerate	VBN
deaerates	deaerate	VBZ
deaerating	deaerate	VBG
decaampere	decaampere	NN
decaamperes	decaampere	NNS
decabecquerel	decabecquerel	NN
decabecquerels	decabecquerel	NNS
decacandela	decacandela	NN
decacandelas	decacandela	NNS
decacoulomb	decacoulomb	NN
decacoulombs	decacoulomb	NNS
decafarad	decafarad	NN
decafarads	decafarad	NNS
decagray	decagray	NN
decagrays	decagray	NNS
decahenries	decahenry	NNS
decahenry	decahenry	NN
decahertz	decahertz	NN
decahertz	decahertz	NNS
decajoule	decajoule	NN
decajoules	decajoule	NNS
decakatal	decakatal	NN
decakatals	decakatal	NNS
decakelvin	decakelvin	NN
decakelvins	decakelvin	NNS
decalumen	decalumen	NN
decalumens	decalumen	NNS
decalux	decalux	NN
decalux	decalux	NNS
decamole	decamole	NN
decamoles	decamole	NNS
decanewton	decanewton	NN
decanewtons	decanewton	NNS
decaohm	decaohm	NN
decaohms	decaohm	NNS
decapascal	decapascal	NN
decapascals	decapascal	NNS
decapitalise	decapitalise	VB
decapitalise	decapitalise	VBP
decapitalised	decapitalise	VBD
decapitalised	decapitalise	VBN
decapitalises	decapitalise	VBZ
decapitalising	decapitalise	VBG
decapitalize	decapitalize	VB
decapitalize	decapitalize	VBP
decapitalized	decapitalize	VBD
decapitalized	decapitalize	VBN
decapitalizes	decapitalize	VBZ
decapitalizing	decapitalize	VBG
decaradian	decaradian	NN
decaradians	decaradian	NNS
decarbonise	decarbonise	VB
decarbonise	decarbonise	VBP
decarbonised	decarbonise	VBD
decarbonised	decarbonise	VBN
decarbonises	decarbonise	VBZ
decarbonising	decarbonise	VBG
decasiemens	decasiemens	NN
decasiemens	decasiemens	NNS
decasievert	decasievert	NN
decasieverts	decasievert	NNS
decasteradian	decasteradian	NN
decasteradians	decasteradian	NNS
decatesla	decatesla	NN
decateslas	decatesla	NNS
decavolt	decavolt	NN
decavolts	decavolt	NNS
decawatt	decawatt	NN
decawatts	decawatt	NNS
decaweber	decaweber	NN
decawebers	decaweber	NNS
DECEMBER	December	NNP
deciampere	deciampere	NN
deciamperes	deciampere	NNS
decibecquerel	decibecquerel	NN
decibecquerels	decibecquerel	NNS
decicandela	decicandela	NN
decicandelas	decicandela	NNS
decicoulomb	decicoulomb	NN
decicoulombs	decicoulomb	NNS
decifarad	decifarad	NN
decifarads	decifarad	NNS
decigray	decigray	NN
decigrays	decigray	NNS
decihenries	decihenry	NNS
decihenry	decihenry	NN
decihertz	decihertz	NN
decihertz	decihertz	NNS
decijoule	decijoule	NN
decijoules	decijoule	NNS
decikatal	decikatal	NN
decikatals	decikatal	NNS
decikelvin	decikelvin	NN
decikelvins	decikelvin	NNS
decilumen	decilumen	NN
decilumens	decilumen	NNS
decilux	decilux	NN
decilux	decilux	NNS
decimole	decimole	NN
decimoles	decimole	NNS
decinewton	decinewton	NN
decinewtons	decinewton	NNS
deciohm	deciohm	NN
deciohms	deciohm	NNS
decipascal	decipascal	NN
decipascals	decipascal	NNS
deciradian	deciradian	NN
deciradians	deciradian	NNS
decisiemens	decisiemens	NN
decisiemens	decisiemens	NNS
decisievert	decisievert	NN
decisieverts	decisievert	NNS
decisteradian	decisteradian	NN
decisteradians	decisteradian	NNS
decitesla	decitesla	NN
deciteslas	decitesla	NNS
decivolt	decivolt	NN
decivolts	decivolt	NNS
deciwatt	deciwatt	NN
deciwatts	deciwatt	NNS
deciweber	deciweber	NN
deciwebers	deciweber	NNS
decontextualise	decontextualise	VB
decontextualise	decontextualise	VBP
decontextualised	decontextualise	VBD
decontextualised	decontextualise	VBN
decontextualises	decontextualise	VBZ
decontextualising	decontextualise	VBG
decontextualize	decontextualize	VB
decontextualize	decontextualize	VBP
decontextualized	decontextualize	VBD
decontextualized	decontextualize	VBN
decontextualizes	decontextualize	VBZ
decontextualizing	decontextualize	VBG
decriminalisation	decriminalisation	NN:UN
de-emphasize	de-emphasize	VB
de-emphasize	de-emphasize	VBP
de-emphasized	de-emphasize	VBD
de-emphasized	de-emphasize	VBN
de-emphasizes	de-emphasize	VBZ
de-emphasizing	de-emphasize	VBG
de-energize	de-energize	VB
de-energize	de-energize	VBP
de-energized	de-energize	VBD
de-energized	de-energize	VBN
de-energizes	de-energize	VBZ
de-energizing	de-energize	VBG
defuel	defuel	VB
defuel	defuel	VBP
defueled	defuel	VBD
defueled	defuel	VBN
defueling	defuel	VBG
defueling	defueling	NN:UN
defuelings	defueling	NNS
defuelled	defuel	VBD
defuelled	defuel	VBN
defuelling	defuel	VBG
defuelling	defuelling	NN:U
defuellings	defuelling	NNS
defuels	defuel	VBZ
deglamorise	deglamorise	VB
deglamorise	deglamorise	VBP
deglamorised	deglamorise	VBD
deglamorised	deglamorise	VBN
deglamorises	deglamorise	VBZ
deglamorising	deglamorise	VBG
deglamorize	deglamorize	VB
deglamorize	deglamorize	VBP
deglamorized	deglamorize	VBD
deglamorized	deglamorize	VBN
deglamorizes	deglamorize	VBZ
deglamorizing	deglamorize	VBG
degrease	degrease	VB
degrease	degrease	VBP
degreased	degrease	VBD
degreased	degrease	VBN
degreases	degrease	VBZ
degreasing	degrease	VBG
dekaampere	dekaampere	NN
dekaamperes	dekaampere	NNS
dekabecquerel	dekabecquerel	NN
dekabecquerels	dekabecquerel	NNS
dekacandela	dekacandela	NN
dekacandelas	dekacandela	NNS
dekacoulomb	dekacoulomb	NN
dekacoulombs	dekacoulomb	NNS
dekafarad	dekafarad	NN
dekafarads	dekafarad	NNS
dekagray	dekagray	NN
dekagrays	dekagray	NNS
dekahenries	dekahenry	NNS
dekahenry	dekahenry	NN
dekahertz	dekahertz	NN
dekahertz	dekahertz	NNS
dekajoule	dekajoule	NN
dekajoules	dekajoule	NNS
dekakatal	dekakatal	NN
dekakatals	dekakatal	NNS
dekakelvin	dekakelvin	NN
dekakelvins	dekakelvin	NNS
dekalumen	dekalumen	NN
dekalumens	dekalumen	NNS
dekalux	dekalux	NN
dekalux	dekalux	NNS
dekamole	dekamole	NN
dekamoles	dekamole	NNS
dekanewton	dekanewton	NN
dekanewtons	dekanewton	NNS
dekaohm	dekaohm	NN
dekaohms	dekaohm	NNS
dekapascal	dekapascal	NN
dekapascals	dekapascal	NNS
dekaradian	dekaradian	NN
dekaradians	dekaradian	NNS
dekasiemens	dekasiemens	NN
dekasiemens	dekasiemens	NNS
dekasievert	dekasievert	NN
dekasieverts	dekasievert	NNS
dekasteradian	dekasteradian	NN
dekasteradians	dekasteradian	NNS
dekatesla	dekatesla	NN
dekateslas	dekatesla	NNS
dekavolt	dekavolt	NN
dekavolts	dekavolt	NNS
dekawatt	dekawatt	NN
dekawatts	dekawatt	NNS
dekaweber	dekaweber	NN
dekawebers	dekaweber	NNS
deliverables	deliverable	NNS
delocalise	delocalise	VB
delocalise	delocalise	VBP
delocalised	delocalise	VBD
delocalised	delocalise	VBN
delocalises	delocalise	VBZ
delocalising	delocalise	VBG
delocalize	delocalize	VB
delocalize	delocalize	VBP
delocalized	delocalize	VBD
delocalized	delocalize	VBN
delocalizes	delocalize	VBZ
delocalizing	delocalize	VBG
dematerialise	dematerialise	VB
dematerialise	dematerialise	VBP
dematerialised	dematerialise	VBD
dematerialised	dematerialise	VBN
dematerialises	dematerialise	VBZ
dematerialising	dematerialise	VBG
demineralise	demineralise	VB
demineralise	demineralise	VBP
demineralised	demineralise	VBD
demineralised	demineralise	VBN
demineralises	demineralise	VBZ
demineralising	demineralise	VBG
demineralize	demineralize	VB
demineralize	demineralize	VBP
demineralized	demineralize	VBD
demineralized	demineralize	VBN
demineralizes	demineralize	VBZ
demineralizing	demineralize	VBG
demonisation	demonisation	NN:U
demonise	demonise	VB
demonise	demonise	VBP
demonised	demonise	VBD
demonised	demonise	VBN
demonises	demonise	VBZ
demonising	demonise	VG
denaturalise	denaturalise	VB
denaturalise	denaturalise	VBP
denaturalised	denaturalise	VBD
denaturalised	denaturalise	VBN
denaturalises	denaturalise	VBZ
denaturalising	denaturalise	VBG
denormalisation	denormalisation	NN:UN
denormalize	denormalize	VB
denormalize	denormalize	VBP
denormalized	denormalize	VBD
denormalized	denormalize	VBN
denormalizes	denormalize	VBZ
denormalizing	denormalize	VBG
depoliticisation	depoliticisation	NN:UN
depressurisation	depressurisation	NN:U
depressurise	depressurise	VB
depressurise	depressurise	VBP
depressurised	depressurise	VBD
depressurised	depressurise	VBN
depressurises	depressurise	VBZ
depressurising	depressurise	VBG
deputisation	deputisation	NN
deputisations	deputisation	NNS
derecognise	derecognise	VB
derecognise	derecognise	VBP
derecognised	derecognise	VBD
derecognised	derecognise	VBN
derecognises	derecognise	VBZ
derecognising	derecognise	VBG
desacralise	desacralise	VB
desacralise	desacralise	VBP
desacralised	desacralise	VBD
desacralised	desacralise	VBN
desacralises	desacralise	VBZ
desacralising	desacralise	VBG
desacralize	desacralize	VB
desacralize	desacralize	VBP
desacralized	desacralize	VBD
desacralized	desacralize	VBN
desacralizes	desacralize	VBZ
desacralizing	desacralize	VBG
deselect	deselect	VB
deselect	deselect	VBP
deselected	deselect	VBD
deselected	deselect	VBN
deselecting	deselect	VBG
deselects	deselect	VBZ
desexualise	desexualise	VB
desexualise	desexualise	VBP
desexualised	desexualise	VBD
desexualised	desexualise	VBN
desexualises	desexualise	VBZ
desexualising	desexualise	VBG
destabilisation	destabilisation	NN:UN
destalinise	destalinise	VB
destalinise	destalinise	VBP
destalinised	destalinise	VBD
destalinised	destalinise	VBN
destalinises	destalinise	VBZ
destalinising	destalinise	VBG
destalinize	destalinize	VB
destalinize	destalinize	VBP
destalinized	destalinize	VBD
destalinized	destalinize	VBN
destalinizes	destalinize	VBZ
destalinizing	destalinize	VBG
destigmatise	destigmatise	VB
destigmatise	destigmatise	VBP
destigmatised	destigmatise	VBD
destigmatised	destigmatise	VBN
destigmatises	destigmatise	VBZ
destigmatising	destigmatise	VBG
destigmatize	destigmatize	VB
destigmatize	destigmatize	VBP
destigmatized	destigmatize	VBD
destigmatized	destigmatize	VBN
destigmatizes	destigmatize	VBZ
destigmatizing	destigmatize	VBG
desulphurise	desulphurise	VB
desulphurise	desulphurise	VBP
desulphurised	desulphurise	VBD
desulphurised	desulphurise	VBN
desulphurises	desulphurise	VBZ
desulphurising	desulphurise	VBG
desulphurize	desulphurize	VB
desulphurize	desulphurize	VBP
desulphurized	desulphurize	VBD
desulphurized	desulphurize	VBN
desulphurizes	desulphurize	VBZ
desulphurizing	desulphurize	VBG
detergent	detergent	NN
developing	developing	JJ
dial-up	dial-up	JJ
digitalise	digitalise	VB
digitalise	digitalise	VBP
digitalised	digitalise	VBD
digitalised	digitalise	VBN
digitalises	digitalise	VBZ
dimerise	dimerise	VB
dimerise	dimerise	VBP
dimerised	dimerise	VBD
dimerised	dimerise	VBN
dimerises	dimerise	VBZ
dimerising	dimerise	VBG
dimerize	dimerize	VB
dimerize	dimerize	VBP
dimerized	dimerize	VBD
dimerized	dimerize	VBN
dimerizes	dimerize	VBZ
dimerizing	dimerize	VBG
disambiguator	disambiguator	NN
disambiguators	disambiguator	NNS
disinfectant	disinfectant	NN
disorganised	disorganised	JJ
disorganized	disorganized	JJ
Dnipro	Dnipro	NNP
documentation	documentation	NN
dolomitise	dolomitise	VB
dolomitise	dolomitise	VBP
dolomitised	dolomitise	VBD
dolomitised	dolomitise	VBN
dolomitises	dolomitise	VBZ
dolomitising	dolomitise	VBG
dolomitize	dolomitize	VB
dolomitize	dolomitize	VBP
dolomitized	dolomitize	VBD
dolomitized	dolomitize	VBN
dolomitizes	dolomitize	VBZ
dolomitizing	dolomitize	VBG
domesticated	domesticated	JJ
double-click	double-click	VB
double-click	double-click	VBP
double-clicked	double-click	VBD
double-clicked	double-click	VBN
double-clicking	double-click	VBG
double-clicks	double-click	VBZ
download	download	NN
downloads	download	NNS
Doxygen	Doxygen	NNP
drag	drag	NN
drag-and-drop	drag-and-drop	JJ
droopily	droopily	RB
drop-down	drop-down	JJ
Drupal	Drupal	NNP
dynamise	dynamise	VB
dynamise	dynamise	VBP
dynamised	dynamise	VBD
dynamised	dynamise	VBN
dynamises	dynamise	VBZ
dynamising	dynamise	VBG
ebonise	ebonise	VB
ebonise	ebonise	VBP
ebonised	ebonise	VBD
ebonised	ebonise	VBN
ebonises	ebonise	VBZ
ebonising	ebonise	VBG
economisation	economisation	NN:UN
economization	economization	NN:UN
edifying	edifying	JJ
e-learning	e-learning	NN:U
electrolyse	electrolyse	VB
electrolyse	electrolyse	VBP
electrolysed	electrolyse	VBD
electrolysed	electrolyse	VBN
electrolyses	electrolyse	VBZ
electrolysing	electrolyse	VBG
electrolyze	electrolyze	VB
electrolyze	electrolyze	VBP
electrolyzed	electrolyze	VBD
electrolyzed	electrolyze	VBN
electrolyzes	electrolyze	VBZ
electrolyzing	electrolyze	VBG
electronvolts	electronvolt	NNS
elevenfold	elevenfold	JJ
elevenfold	elevenfold	RB
Elmbridge	Elmbridge	NNP
e-mail	e-mail	NN
émigré	émigré	NN
émigrés	émigré	NNS
emoji	emoji	NN
emojis	emoji	NNS
end-user	end-user	JJ
engrain	engrain	VB
engrain	engrain	VBP
engrained	engrain	VBD
engrained	engrain	VBN
engraining	engrain	VBG
engrains	engrain	VBZ
ensuing	ensuing	JJ
entry-level	entry-level	JJ
eroticise	eroticise	VB
eroticise	eroticise	VBP
eroticised	eroticise	VBD
eroticised	eroticise	VBN
eroticises	eroticise	VBZ
eroticising	eroticise	VBG
eroticize	eroticize	VB
eroticize	eroticize	VBP
eroticized	eroticize	VBD
eroticized	eroticize	VBN
eroticizes	eroticize	VBZ
eroticizing	eroticize	VBG
erotise	erotise	VB
erotise	erotise	VBP
erotised	erotise	VBD
erotised	erotise	VBN
erotises	erotise	VBZ
erotising	erotise	VBG
erotize	erotize	VB
erotize	erotize	VBP
erotized	erotize	VBD
erotized	erotize	VBN
erotizes	erotize	VBZ
erotizing	erotize	VBG
etc	etc	RB
eternalise	eternalise	VB
eternalise	eternalise	VBP
eternalised	eternalise	VBD
eternalised	eternalise	VBN
eternalises	eternalise	VBZ
eternalising	eternalise	VBG
euphemise	euphemise	VB
euphemise	euphemise	VBP
euphemised	euphemise	VBD
euphemised	euphemise	VBN
euphemises	euphemise	VBZ
euphemising	euphemise	VBG
exaampere	exaampere	NN
exaamperes	exaampere	NNS
exabecquerel	exabecquerel	NN
exabecquerels	exabecquerel	NNS
exacandela	exacandela	NN
exacandelas	exacandela	NNS
exacoulomb	exacoulomb	NN
exacoulombs	exacoulomb	NNS
exafarad	exafarad	NN
exafarads	exafarad	NNS
exagram	exagram	NN
exagramme	exagramme	NN
exagrammes	exagramme	NNS
exagrams	exagram	NNS
exagray	exagray	NN
exagrays	exagray	NNS
exahenries	exahenry	NNS
exahenry	exahenry	NN
exahertz	exahertz	NN
exahertz	exahertz	NNS
exajoule	exajoule	NN
exajoules	exajoule	NNS
exakatal	exakatal	NN
exakatals	exakatal	NNS
exakelvin	exakelvin	NN
exakelvins	exakelvin	NNS
exaliter	exaliter	NN
exaliters	exaliter	NNS
exalitre	exalitre	NN
exalitres	exalitre	NNS
exalumen	exalumen	NN
exalumens	exalumen	NNS
exalux	exalux	NN
exalux	exalux	NNS
exameter	exameter	NN
exameters	exameter	NNS
exametre	exametre	NN
exametres	exametre	NNS
examole	examole	NN
examoles	examole	NNS
exanewton	exanewton	NN
exanewtons	exanewton	NNS
exaohm	exaohm	NN
exaohms	exaohm	NNS
exapascal	exapascal	NN
exapascals	exapascal	NNS
exaradian	exaradian	NN
exaradians	exaradian	NNS
exasiemens	exasiemens	NN
exasiemens	exasiemens	NNS
exasievert	exasievert	NN
exasieverts	exasievert	NNS
exasteradian	exasteradian	NN
exasteradians	exasteradian	NNS
exatesla	exatesla	NN
exateslas	exatesla	NNS
exavolt	exavolt	NN
exavolts	exavolt	NNS
exawatt	exawatt	NN
exawatts	exawatt	NNS
exaweber	exaweber	NN
exawebers	exaweber	NNS
Excel	Excel	NNP
excluding	excluding	IN
façade	façade	NN
façades	façade	NNS
Facebook	Facebook	NNP
factionalise	factionalise	VB
factionalise	factionalise	VBP
factionalised	factionalise	VBD
factionalised	factionalise	VBN
factionalises	factionalise	VBZ
factionalising	factionalise	VBG
factionalize	factionalize	VB
factionalize	factionalize	VBP
factionalized	factionalize	VBD
factionalized	factionalize	VBN
factionalizes	factionalize	VBZ
factionalizing	factionalize	VBG
FEBRUARY	February	NNP
feminize	feminize	VB
feminize	feminize	VBP
feminized	feminize	VBD
feminized	feminize	VBN
feminizes	feminize	VBZ
feminizing	feminize	VBG
femtoampere	femtoampere	NN
femtoamperes	femtoampere	NNS
femtobecquerel	femtobecquerel	NN
femtobecquerels	femtobecquerel	NNS
femtocandela	femtocandela	NN
femtocandelas	femtocandela	NNS
femtocoulomb	femtocoulomb	NN
femtocoulombs	femtocoulomb	NNS
femtofarad	femtofarad	NN
femtofarads	femtofarad	NNS
femtogram	femtogram	NN
femtogramme	femtogramme	NN
femtogrammes	femtogramme	NNS
femtograms	femtogram	NNS
femtogray	femtogray	NN
femtograys	femtogray	NNS
femtohenries	femtohenry	NNS
femtohenry	femtohenry	NN
femtohertz	femtohertz	NN
femtohertz	femtohertz	NNS
femtojoule	femtojoule	NN
femtojoules	femtojoule	NNS
femtokatal	femtokatal	NN
femtokatals	femtokatal	NNS
femtokelvin	femtokelvin	NN
femtokelvins	femtokelvin	NNS
femtoliter	femtoliter	NN
femtoliters	femtoliter	NNS
femtolitre	femtolitre	NN
femtolitres	femtolitre	NNS
femtolumen	femtolumen	NN
femtolumens	femtolumen	NNS
femtolux	femtolux	NN
femtolux	femtolux	NNS
femtometers	femtometer	NNS
femtometres	femtometre	NNS
femtomole	femtomole	NN
femtomoles	femtomole	NNS
femtonewton	femtonewton	NN
femtonewtons	femtonewton	NNS
femtoohm	femtoohm	NN
femtoohms	femtoohm	NNS
femtopascal	femtopascal	NN
femtopascals	femtopascal	NNS
femtoradian	femtoradian	NN
femtoradians	femtoradian	NNS
femtosiemens	femtosiemens	NN
femtosiemens	femtosiemens	NNS
femtosievert	femtosievert	NN
femtosieverts	femtosievert	NNS
femtosteradian	femtosteradian	NN
femtosteradians	femtosteradian	NNS
femtotesla	femtotesla	NN
femtoteslas	femtotesla	NNS
femtovolt	femtovolt	NN
femtovolts	femtovolt	NNS
femtowatt	femtowatt	NN
femtowatts	femtowatt	NNS
femtoweber	femtoweber	NN
femtowebers	femtoweber	NNS
ferrying	ferrying	NN:U
fetishise	fetishise	VB
fetishise	fetishise	VBP
fetishised	fetishise	VBD
fetishised	fetishise	VBN
fetishises	fetishise	VBZ
fetishising	fetishise	VBG
fetishize	fetishize	VB
fetishize	fetishize	VBP
fetishized	fetishize	VBD
fetishized	fetishize	VBN
fetishizes	fetishize	VBZ
fetishizing	fetishize	VBG
Firefox	Firefox	NNP
flipchart	flipchart	NN
flipcharts	flipchart	NNS
FontoXML	FontoXML	NNP
food	food	NN
formularise	formularise	VB
formularise	formularise	VBP
formularised	formularise	VBD
formularised	formularise	VBN
formularises	formularise	VBZ
formularising	formularise	VBG
fourteenfold	fourteenfold	JJ
fourteenfold	fourteenfold	RB
friction	friction	NN
FRIDAY	Friday	NNP
frustrated	frustrated	JJ
frustrating	frustrating	JJ
fuel	fuel	NN
gas	gas	NN
ghettoisation	ghettoisation	NN:UN
ghettoisations	ghettoisation	NNS
gigaampere	gigaampere	NN
gigaamperes	gigaampere	NNS
gigabecquerel	gigabecquerel	NN
gigabecquerels	gigabecquerel	NNS
gigacandela	gigacandela	NN
gigacandelas	gigacandela	NNS
gigacoulomb	gigacoulomb	NN
gigacoulombs	gigacoulomb	NNS
gigafarad	gigafarad	NN
gigafarads	gigafarad	NNS
gigagram	gigagram	NN
gigagramme	gigagramme	NN
gigagrammes	gigagramme	NNS
gigagrams	gigagram	NNS
gigagray	gigagray	NN
gigagrays	gigagray	NNS
gigahenries	gigahenry	NNS
gigahenry	gigahenry	NN
gigajoule	gigajoule	NN
gigajoules	gigajoule	NNS
gigakatal	gigakatal	NN
gigakatals	gigakatal	NNS
gigakelvin	gigakelvin	NN
gigakelvins	gigakelvin	NNS
gigaliter	gigaliter	NN
gigaliters	gigaliter	NNS
gigalitre	gigalitre	NN
gigalitres	gigalitre	NNS
gigalumen	gigalumen	NN
gigalumens	gigalumen	NNS
gigalux	gigalux	NN
gigalux	gigalux	NNS
gigameters	gigameter	NNS
gigametre	gigametre	NN
gigametres	gigametre	NNS
gigamole	gigamole	NN
gigamoles	gigamole	NNS
giganewton	giganewton	NN
giganewtons	giganewton	NNS
gigaohm	gigaohm	NN
gigaohms	gigaohm	NNS
gigapascal	gigapascal	NN
gigapascals	gigapascal	NNS
gigaradian	gigaradian	NN
gigaradians	gigaradian	NNS
gigasiemens	gigasiemens	NN
gigasiemens	gigasiemens	NNS
gigasievert	gigasievert	NN
gigasieverts	gigasievert	NNS
gigasteradian	gigasteradian	NN
gigasteradians	gigasteradian	NNS
gigatesla	gigatesla	NN
gigateslas	gigatesla	NNS
gigavolt	gigavolt	NN
gigavolts	gigavolt	NNS
gigaweber	gigaweber	NN
gigawebers	gigaweber	NNS
GitHub	GitHub	NNP
glass	glass	NN
glasspaper	glasspaper	NN:U
glideslope	glideslope	NN
glideslopes	glideslope	NNS
glitchier	glitchy	JJR
glitchiest	glitchy	JJS
glitchy	glitchy	JJ
globalise	globalise	VB
globalise	globalise	VBP
globalised	globalise	VBD
globalised	globalise	VBN
globalises	globalise	VBZ
globalising	globalise	VBG
globalize	globalize	VB
globalize	globalize	VBP
globalized	globalize	VBD
globalized	globalize	VBN
globalizes	globalize	VBZ
globalizing	globalize	VBG
Gmail	Gmail	adj
Google	Google	NNP
graduation	graduation	NN
graphene	graphene	NN:U
grayscale	grayscale	JJ
greyscale	greyscale	JJ
gripping	gripping	JJ
groundbreaking	groundbreaking	JJ
guiding	guiding	JJ
hashtag	hashtag	NN
hashtags	hashtag	NNS
headstrap	headstrap	NN
headstraps	headstrap	NNS
hectoampere	hectoampere	NN
hectoamperes	hectoampere	NNS
hectobecquerel	hectobecquerel	NN
hectobecquerels	hectobecquerel	NNS
hectocandela	hectocandela	NN
hectocandelas	hectocandela	NNS
hectocoulomb	hectocoulomb	NN
hectocoulombs	hectocoulomb	NNS
hectofarad	hectofarad	NN
hectofarads	hectofarad	NNS
hectogray	hectogray	NN
hectograys	hectogray	NNS
hectohenries	hectohenry	NNS
hectohenry	hectohenry	NN
hectohertz	hectohertz	NN
hectohertz	hectohertz	NNS
hectojoule	hectojoule	NN
hectojoules	hectojoule	NNS
hectokatal	hectokatal	NN
hectokatals	hectokatal	NNS
hectokelvin	hectokelvin	NN
hectokelvins	hectokelvin	NNS
hectolumen	hectolumen	NN
hectolumens	hectolumen	NNS
hectolux	hectolux	NN
hectolux	hectolux	NNS
hectomole	hectomole	NN
hectomoles	hectomole	NNS
hectonewton	hectonewton	NN
hectonewtons	hectonewton	NNS
hectoohm	hectoohm	NN
hectoohms	hectoohm	NNS
hectopascal	hectopascal	NN
hectopascals	hectopascal	NNS
hectoradian	hectoradian	NN
hectoradians	hectoradian	NNS
hectosiemens	hectosiemens	NN
hectosiemens	hectosiemens	NNS
hectosievert	hectosievert	NN
hectosieverts	hectosievert	NNS
hectosteradian	hectosteradian	NN
hectosteradians	hectosteradian	NNS
hectotesla	hectotesla	NN
hectoteslas	hectotesla	NNS
hectovolt	hectovolt	NN
hectovolts	hectovolt	NNS
hectowatt	hectowatt	NN
hectowatts	hectowatt	NNS
hectoweber	hectoweber	NN
hectowebers	hectoweber	NNS
heparinise	heparinise	VB
heparinise	heparinise	VBP
heparinised	heparinise	VBD
heparinised	heparinise	VBN
heparinises	heparinise	VBZ
heparinising	heparinise	VBG
heparinize	heparinize	VB
heparinize	heparinize	VBP
heparinized	heparinize	VBD
heparinized	heparinize	VBN
heparinizes	heparinize	VBZ
heparinizing	heparinize	VBG
heterodimer	heterodimer	NN
heterodimeric	heterodimeric	JJ
heterodimerise	heterodimerise	VB
heterodimerise	heterodimerise	VBP
heterodimerised	heterodimerise	VBD
heterodimerised	heterodimerise	VBN
heterodimerises	heterodimerise	VBZ
heterodimerising	heterodimerise	VBG
heterodimerize	heterodimerize	VB
heterodimerize	heterodimerize	VBP
heterodimerized	heterodimerize	VBD
heterodimerized	heterodimerize	VBN
heterodimerizes	heterodimerize	VBZ
heterodimerizing	heterodimerize	VBG
heterodimers	heterodimer	NNS
hierarchise	hierarchise	VB
hierarchise	hierarchise	VBP
hierarchised	hierarchise	VBD
hierarchised	hierarchise	VBN
hierarchises	hierarchise	VBZ
hierarchising	hierarchise	VBG
hierarchize	hierarchize	VB
hierarchize	hierarchize	VBP
hierarchized	hierarchize	VBD
hierarchized	hierarchize	VBN
hierarchizes	hierarchize	VBZ
hierarchizing	hierarchize	VBG
higgledy-piggledy	higgledy-piggledy	JJ
higgledy-piggledy	higgledy-piggledy	RB
highflier	highflier	NN
highfliers	highflier	NNS
historicise	historicise	VB
historicise	historicise	VBP
historicised	historicise	VBD
historicised	historicise	VBN
historicises	historicise	VBZ
historicising	historicise	VBG
historicize	historicize	VB
historicize	historicize	VBP
historicized	historicize	VBD
historicized	historicize	VBN
historicizes	historicize	VBZ
historicizing	historicize	VBG
honorable	honorable	JJ
hosting	hosting	NN:UN
hostings	hosting	NNS
hyperlink	hyperlink	NN
hyperlink	hyperlink	VB
hyperlink	hyperlink	VBP
hyperlinked	hyperlink	VBD
hyperlinked	hyperlink	VBN
hyperlinking	hyperlink	VBG
hyperlinks	hyperlink	NNS
hyperlinks	hyperlink	VBZ
hypostatical	hypostatical	JJ
hypostatisations	hypostatisation	NNS
hypostatise	hypostatise	VB
hypostatise	hypostatise	VBP
hypostatised	hypostatise	VBD
hypostatised	hypostatise	VBN
hypostatises	hypostatise	VBZ
hypostatising	hypostatise	VBG
hypothesise	hypothesise	VB
hypothesise	hypothesise	VBP
hypothesised	hypothesise	VBD
hypothesised	hypothesise	VBN
hypothesises	hypothesise	VBZ
iBook	iBook	NNP
iBooks	iBooks	NNP
immobilisable	immobilisable	JJ
immobilizable	immobilizable	JJ
imperial	imperial	JJ
imperialise	imperialise	VB
imperialise	imperialise	VBP
imperialised	imperialise	VBD
imperialised	imperialise	VBN
imperialises	imperialise	VBZ
imperialising	imperialise	VBG
imperialize	imperialize	VB
imperialize	imperialize	VBP
imperialized	imperialize	VBD
imperialized	imperialize	VBN
imperializes	imperialize	VBZ
imperializing	imperialize	VBG
incentivise	incentivise	VB
incentivise	incentivise	VBP
incentivised	incentivise	VBD
incentivised	incentivise	VBN
incentivises	incentivise	VBZ
incentivising	incentivise	VBG
incentivization	incentivization	NN:UN
incentivize	incentivize	VB
incentivize	incentivize	VBP
incentivized	incentivize	VBD
incentivized	incentivize	VBN
incentivizes	incentivize	VBZ
incentivizing	incentivize	VBG
incidence	incidence	NN
inclined	inclined	JJ
inebriated	inebriated	JJ
infantilise	infantilise	VB
infantilise	infantilise	VBP
infantilised	infantilise	VBD
infantilised	infantilise	VBN
infantilises	infantilise	VBZ
infantilising	infantilise	VBG
infantilize	infantilize	VB
infantilize	infantilize	VBP
infantilized	infantilize	VBD
infantilized	infantilize	VBN
infantilizes	infantilize	VBZ
infantilizing	infantilize	VBG
infographic	infographic	NN
infographics	infographic	NNS
inspiring	inspiring	JJ
interlaid	interlay	VBD
interlaid	interlay	VBN
interlay	interlay	NN
interlay	interlay	VB
interlay	interlay	VBP
interlaying	interlay	VBG
interlays	interlay	NNS
interlays	interlay	VBZ
Ivano-Frankivsk	Ivano-Frankivsk	NNP
JANUARY	January	NNP
jarring	jarring	JJ
Javadoc	Javadoc	NNP
JavaHelp	JavaHelp	NNP
jQuery	jQuery	NNP
JULY	July	NNP
JUNE	June	NNP
katal	katal	NN
katals	katal	NNS
Kharkiv	Kharkiv	NNP
Khmelnytskyi	Khmelnytskyi	NNP
kiloamperes	kiloampere	NNS
kilobecquerel	kilobecquerel	NN
kilobecquerels	kilobecquerel	NNS
kilocandela	kilocandela	NN
kilocandelas	kilocandela	NNS
kilocoulomb	kilocoulomb	NN
kilocoulombs	kilocoulomb	NNS
kilofarad	kilofarad	NN
kilofarads	kilofarad	NNS
kilogray	kilogray	NN
kilograys	kilogray	NNS
kilohenries	kilohenry	NNS
kilohenry	kilohenry	NN
kilohms	kilohm	NNS
kilokatal	kilokatal	NN
kilokatals	kilokatal	NNS
kilokelvin	kilokelvin	NN
kilokelvins	kilokelvin	NNS
kilolumens	kilolumen	NNS
kilolux	kilolux	NN
kilolux	kilolux	NNS
kilonewton	kilonewton	NN
kilonewtons	kilonewton	NNS
kiloradian	kiloradian	NN
kiloradians	kiloradian	NNS
kilosiemens	kilosiemens	NN
kilosiemens	kilosiemens	NNS
kilosievert	kilosievert	NN
kilosieverts	kilosievert	NNS
kilosteradian	kilosteradian	NN
kilosteradians	kilosteradian	NNS
kilotesla	kilotesla	NN
kiloteslas	kilotesla	NNS
kiloweber	kiloweber	NN
kilowebers	kiloweber	NNS
Kirklees	Kirklees	NNP
Kremenchuk	Kremenchuk	NNP
Kropyvnytskyi	Kropyvnytskyi	NNP
Kyiv	Kyiv	NNP
Lambourne	Lambourne	NNP
land	land	NN
lateralise	lateralise	VB
lateralise	lateralise	VBP
lateralised	lateralise	VBD
lateralised	lateralise	VBN
lateralises	lateralise	VBZ
lateralising	lateralise	VBG
lateralize	lateralize	VB
lateralize	lateralize	VBP
lateralized	lateralize	VBD
lateralized	lateralize	VBN
lateralizes	lateralize	VBZ
lateralizing	lateralize	VBG
lemmatisation	lemmatisation	NN:U
lemmatise	lemmatise	VB
lemmatise	lemmatise	VBP
lemmatised	lemmatise	VBD
lemmatised	lemmatise	VBN
lemmatises	lemmatise	VBZ
lemmatising	lemmatise	VBG
lemmatization	lemmatization	NN:U
lemmatize	lemmatize	VB
lemmatize	lemmatize	VBP
lemmatized	lemmatize	VBD
lemmatized	lemmatize	VBN
lemmatizes	lemmatize	VBZ
lemmatizing	lemmatize	VBG
letterbox	letterbox	NN
letterboxes	letterbox	NNS
LexisNexis	LexisNexis	NNP
LibreOffice	LibreOffice	NNP
lifecycle	lifecycle	NN
lifecycles	lifecycle	NNS
liferaft	liferaft	NN
liferafts	liferaft	NNS
lighter	lighter	VB
lightered	lighter	VBD
lightered	lighter	VBN
lightering	lighter	VBG
lighters	lighter	VBZ
LinkedIn	LinkedIn	NNP
liquidisation	liquidisation	NN:UN
liquidization	liquidization	NN:UN
login	login	NN
logins	login	NNS
logoff	logoff	NN
logoffs	logoff	NNS
logon	logon	NN
logons	logon	NNS
Luhansk	Luhansk	NNP
Lutsk	Lutsk	NNP
Lviv	Lviv	NNP
lyophilise	lyophilise	VB
lyophilise	lyophilise	VBP
lyophilised	lyophilise	VBD
lyophilised	lyophilise	VBN
lyophilises	lyophilise	VBZ
lyophilising	lyophilise	VBG
magnetisable	magnetisable	JJ
magnetizable	magnetizable	JJ
MailChimp	MailChimp	NNP
malware	malware	NN:U
mandated	mandated	JJ
marbleise	marbleise	VB
marbleise	marbleise	VBP
marbleised	marbleise	VBD
marbleised	marbleise	VBN
marbleises	marbleise	VBZ
marbleising	marbleise	VBG
MARCH	March	NNP
marketization	marketization	NN:U
masculinise	masculinise	VB
masculinise	masculinise	VBP
masculinised	masculinise	VBD
masculinised	masculinise	VBN
masculinises	masculinise	VBZ
masculinising	masculinise	VBG
masculinize	masculinize	VB
masculinize	masculinize	VBP
masculinized	masculinize	VBD
masculinized	masculinize	VBN
masculinizes	masculinize	VBZ
masculinizing	masculinize	VBG
maximiser	maximiser	NN
maximisers	maximiser	NNS
MAY	May	NNP
McAlpine	McAlpine	NNP
mechanisable	mechanisable	JJ
mechanizable	mechanizable	JJ
medicalise	medicalise	VB
medicalise	medicalise	VBP
medicalised	medicalise	VBD
medicalised	medicalise	VBN
medicalises	medicalise	VBZ
medicalising	medicalise	VBG
medicalization	medicalization	NN:U
medicalize	medicalize	VB
medicalize	medicalize	VBP
medicalized	medicalize	VBD
medicalized	medicalize	VBN
medicalizes	medicalize	VBZ
medicalizing	medicalize	VBG
megaampere	megaampere	NN
megaamperes	megaampere	NNS
megabecquerel	megabecquerel	NN
megabecquerels	megabecquerel	NNS
megacandela	megacandela	NN
megacandelas	megacandela	NNS
megacoulomb	megacoulomb	NN
megacoulombs	megacoulomb	NNS
megagram	megagram	NN
megagramme	megagramme	NN
megagrammes	megagramme	NNS
megagrams	megagram	NNS
megagray	megagray	NN
megagrays	megagray	NNS
megahenries	megahenry	NNS
megahenry	megahenry	NN
megakatal	megakatal	NN
megakatals	megakatal	NNS
megakelvin	megakelvin	NN
megakelvins	megakelvin	NNS
megaliter	megaliter	NN
megaliters	megaliter	NNS
megalitre	megalitre	NN
megalitres	megalitre	NNS
megalumen	megalumen	NN
megalumens	megalumen	NNS
megalux	megalux	NN
megalux	megalux	NNS
megameters	megameter	NNS
megametre	megametre	NN
megametres	megametre	NNS
megamole	megamole	NN
megamoles	megamole	NNS
meganewton	meganewton	NN
meganewtons	meganewton	NNS
megapascal	megapascal	NN
megapascals	megapascal	NNS
megapixel	megapixel	NN
megapixels	megapixel	NNS
megaradian	megaradian	NN
megaradians	megaradian	NNS
megasiemens	megasiemens	NN
megasiemens	megasiemens	NNS
megasievert	megasievert	NN
megasieverts	megasievert	NNS
megasteradian	megasteradian	NN
megasteradians	megasteradian	NNS
megatesla	megatesla	NN
megateslas	megatesla	NNS
megaweber	megaweber	NN
megawebers	megaweber	NNS
melodramatise	melodramatise	VB
melodramatise	melodramatise	VBP
melodramatised	melodramatise	VBD
melodramatised	melodramatise	VBN
melodramatises	melodramatise	VBZ
melodramatising	melodramatise	VBG
melodramatize	melodramatize	VB
melodramatize	melodramatize	VBP
melodramatized	melodramatize	VBD
melodramatized	melodramatize	VBN
melodramatizes	melodramatize	VBZ
melodramatizing	melodramatize	VBG
messaging	messaging	NN:U
metal	metal	NN
metastasise	metastasise	VB
metastasise	metastasise	VBP
metastasised	metastasise	VBD
metastasised	metastasise	VBN
metastasises	metastasise	VBZ
metastasising	metastasise	VBG
methodisation	methodisation	NN:UN
methodisations	methodisation	NNS
methodise	methodise	VB
methodise	methodise	VBP
methodised	methodise	VBD
methodised	methodise	VBN
methodises	methodise	VBZ
methodising	methodise	VBG
methodize	methodize	VB
methodize	methodize	VBP
methodized	methodize	VBD
methodized	methodize	VBN
methodizes	methodize	VBZ
methodizing	methodize	VBG
metrics	metric	NNS
microbecquerel	microbecquerel	NN
microbecquerels	microbecquerel	NNS
microcandela	microcandela	NN
microcandelas	microcandela	NNS
microcoulombs	microcoulomb	NNS
microgramme	microgramme	NN
microgrammes	microgramme	NNS
microgray	microgray	NN
micrograys	microgray	NNS
microhertz	microhertz	NN
microhertz	microhertz	NNS
microjoule	microjoule	NN
microjoules	microjoule	NNS
microkatal	microkatal	NN
microkatals	microkatal	NNS
microkelvin	microkelvin	NN
microkelvins	microkelvin	NNS
microlitre	microlitre	NN
microlitres	microlitre	NNS
microlumen	microlumen	NN
microlumens	microlumen	NNS
microlux	microlux	NNS
micromillimeters	micromillimeters	NNS
micromillimetres	micromillimetres	NNS
micronewton	micronewton	NN
micronewtons	micronewton	NNS
microohm	microohm	NN
microohms	microohm	NNS
micropascal	micropascal	NN
micropascals	micropascal	NNS
microradians	microradian	NNS
microsiemens	microsiemens	NNS
microsievert	microsievert	NN
microsieverts	microsievert	NNS
Microsoft	Microsoft	NNP
microsteradian	microsteradian	NN
microsteradians	microsteradian	NNS
microtesla	microtesla	NN
microteslas	microtesla	NNS
microweber	microweber	NN
microwebers	microweber	NNS
millibecquerel	millibecquerel	NN
millibecquerels	millibecquerel	NNS
millicandela	millicandela	NN
millicandelas	millicandela	NNS
millicoulomb	millicoulomb	NN
millicoulombs	millicoulomb	NNS
milligramme	milligramme	NN
milligrammes	milligramme	NNS
milligray	milligray	NN
milligrays	milligray	NNS
millihertz	millihertz	NN
millihertz	millihertz	NNS
millijoule	millijoule	NN
millijoules	millijoule	NNS
millikatal	millikatal	NN
millikatals	millikatal	NNS
millikelvin	millikelvin	NN
millikelvins	millikelvin	NNS
millilumen	millilumen	NN
millilumens	millilumen	NNS
millilux	millilux	NNS
millinewton	millinewton	NN
millinewtons	millinewton	NNS
millipascal	millipascal	NN
millipascals	millipascal	NNS
millisiemens	millisiemens	NNS
millisievert	millisievert	NN
millisieverts	millisievert	NNS
millisteradian	millisteradian	NN
millisteradians	millisteradian	NNS
millitesla	millitesla	NN
milliteslas	millitesla	NNS
milliweber	milliweber	NN
milliwebers	milliweber	NNS
mind-set	mind-set	NN
mind-sets	mind-set	NNS
mineralize	mineralize	VB
mineralize	mineralize	VBP
mineralized	mineralize	VBD
mineralized	mineralize	VBN
mineralizes	mineralize	VBZ
mineralizing	mineralize	VBG
minimisers	minimiser	NNS
misalign	misalign	VB
misalign	misalign	VBP
misaligned	misalign	VBD
misaligned	misalign	VBN
misaligning	misalign	VBG
misaligns	misalign	VBZ
misarrange	misarrange	VB
misarrange	misarrange	VBP
misarranged	misarrange	VBD
misarranged	misarrange	VBN
misarranges	misarrange	VBZ
misarranging	misarrange	VBG
misclassified	misclassify	VBD
misclassified	misclassify	VBN
misclassifies	misclassify	VBZ
misclassify	misclassify	VB
misclassify	misclassify	VBP
misclassifying	misclassify	VBG
miscopied	miscopy	VBD
miscopied	miscopy	VBN
miscopies	miscopy	VBZ
miscopy	miscopy	VB
miscopy	miscopy	VBP
miscopying	miscopy	VBG
miseducate	miseducate	VB
miseducate	miseducate	VBP
miseducated	miseducate	VBD
miseducated	miseducate	VBN
miseducates	miseducate	VBZ
miseducating	miseducate	VBG
misemploy	misemploy	VB
misemploy	misemploy	VBP
misemployed	misemploy	VBD
misemployed	misemploy	VBN
misemploying	misemploy	VBG
misemploys	misemploy	VBZ
miserly	miserly	JJ
misrigged	misrigged	JJ
missort	missort	VB
missort	missort	VBP
missorted	missort	VBD
missorted	missort	VBN
missorting	missort	VBG
missorts	missort	VBZ
mistitle	mistitle	VB
mistitle	mistitle	VBP
mistitled	mistitle	VBD
mistitled	mistitle	VBN
mistitles	mistitle	VBZ
mistitling	mistitle	VBG
mistune	mistune	VB
mistune	mistune	VBP
mistuned	mistune	VBD
mistuned	mistune	VBN
mistunes	mistune	VBZ
mistuning	mistune	VBG
mistype	mistype	VB
mistype	mistype	VBP
mistyped	mistype	VBD
mistyped	mistype	VBN
mistypes	mistype	VBZ
mistyping	mistype	VBG
mitzvot	mitzvah	NNS
mitzvoth	mitzvah	NNS
mix-up	mix-up	NN
mix-ups	mix-up	NNS
mock-up	mock-up	NN
mock-ups	mock-up	NNS
modularization	modularization	NN:UN
modularize	modularize	VB
modularize	modularize	VBP
modularized	modularize	VBD
modularized	modularize	VBN
modularizes	modularize	VBZ
modularizing	modularize	VBG
moiré	moiré	JJ
moiré	moiré	NN:U
MONDAY	Monday	NNP
money-spinning	money-spinning	JJ
money-spinning	money-spinning	NN:U
mounting	mounting	JJ
muchly	muchly	RB
Multimap	Multimap	NNP
multipart	multipart	JJ
mutualise	mutualise	VB
mutualise	mutualise	VBP
mutualised	mutualise	VBD
mutualised	mutualise	VBN
mutualises	mutualise	VBZ
mutualising	mutualise	VBG
mutualize	mutualize	VB
mutualize	mutualize	VBP
mutualized	mutualize	VBD
mutualized	mutualize	VBN
mutualizes	mutualize	VBZ
mutualizing	mutualize	VBG
myeloma	myeloma	NN
myelomas	myeloma	NNS
Mykolaiv	Mykolaiv	NNP
naff	naff	JJ
naffer	naff	JJR
naffest	naff	JJS
naïve	naïve	JJ
nanoampere	nanoampere	NN
nanoamperes	nanoampere	NNS
nanobecquerel	nanobecquerel	NN
nanobecquerels	nanobecquerel	NNS
nanocandela	nanocandela	NN
nanocandelas	nanocandela	NNS
nanocoulomb	nanocoulomb	NN
nanocoulombs	nanocoulomb	NNS
nanofarad	nanofarad	NN
nanofarads	nanofarad	NNS
nanogramme	nanogramme	NN
nanogrammes	nanogramme	NNS
nanogray	nanogray	NN
nanograys	nanogray	NNS
nanohenries	nanohenry	NNS
nanohenry	nanohenry	NN
nanohertz	nanohertz	NN
nanohertz	nanohertz	NNS
nanojoule	nanojoule	NN
nanojoules	nanojoule	NNS
nanokatal	nanokatal	NN
nanokatals	nanokatal	NNS
nanokelvin	nanokelvin	NN
nanokelvins	nanokelvin	NNS
nanoliter	nanoliter	NN
nanoliters	nanoliter	NNS
nanolitre	nanolitre	NN
nanolitres	nanolitre	NNS
nanolumen	nanolumen	NN
nanolumens	nanolumen	NNS
nanolux	nanolux	NN
nanolux	nanolux	NNS
nanomole	nanomole	NN
nanomoles	nanomole	NNS
nanonewton	nanonewton	NN
nanonewtons	nanonewton	NNS
nanoohm	nanoohm	NN
nanoohms	nanoohm	NNS
nanoparticle	nanoparticle	NN
nanoparticles	nanoparticle	NNS
nanopascal	nanopascal	NN
nanopascals	nanopascal	NNS
nanoradian	nanoradian	NN
nanoradians	nanoradian	NNS
nanosiemens	nanosiemens	NN
nanosiemens	nanosiemens	NNS
nanosievert	nanosievert	NN
nanosieverts	nanosievert	NNS
nanosteradian	nanosteradian	NN
nanosteradians	nanosteradian	NNS
nanotube	nanotube	NN
nanotubes	nanotube	NNS
nanovolt	nanovolt	NN
nanovolts	nanovolt	NNS
nanoweber	nanoweber	NN
nanowebers	nanoweber	NNS
neovascularization	neovascularization	NN:U
Newcastle-under-Lyme	Newcastle-under-Lyme	NNP
nineteenfold	nineteenfold	JJ
nineteenfold	nineteenfold	RB
nominalisable	nominalisable	JJ
nominalisation	nominalisation	NN:UN
nominalise	nominalise	VB
nominalise	nominalise	VBP
nominalised	nominalise	VBD
nominalised	nominalise	VBN
nominalises	nominalise	VBZ
nominalising	nominalise	VBG
nominalizable	nominalizable	JJ
nominalize	nominalize	VB
nominalize	nominalize	VBP
nominalized	nominalize	VBD
nominalized	nominalize	VBN
nominalizes	nominalize	VBZ
nominalizing	nominalize	VBG
no-no	no-no	NN
no-nos	no-no	NNS
normalisable	normalisable	JJ
normalizable	normalizable	JJ
notarised	notarised	JJ
notarized	notarized	JJ
NOVEMBER	November	NNP
Nutella	Nutella	NNP
OCTOBER	October	NNP
Odesa	Odesa	NNP
oil	oil	NN
oilfree	oilfree	JJ
onboarding	onboarding	NN:U
on-screen	on-screen	JJ
on-screen	on-screen	RB
onsite	onsite	JJ
onsite	onsite	RB
open-source	open-source	JJ
operationalise	operationalise	VB
operationalise	operationalise	VBP
operationalised	operationalise	VBD
operationalised	operationalise	VBN
operationalises	operationalise	VBZ
operationalising	operationalise	VBG
operationalize	operationalize	VB
operationalize	operationalize	VBP
operationalized	operationalize	VBD
operationalized	operationalize	VBN
operationalizes	operationalize	VBZ
operationalizing	operationalize	VBG
opioid	opioid	JJ
optimisable	optimisable	JJ
optimizable	optimizable	JJ
orthogonalize	orthogonalize	VB
orthogonalize	orthogonalize	VBP
orthogonalized	orthogonalize	VBD
orthogonalized	orthogonalize	VBN
orthogonalizes	orthogonalize	VBZ
orthogonalizing	orthogonalize	VBG
overinflate	overinflate	VB
overinflate	overinflate	VBP
overinflated	overinflate	VBD
overinflated	overinflate	VBN
overinflates	overinflate	VBZ
overinflating	overinflate	VBG
overtighten	overtighten	VB
overtighten	overtighten	VBP
overtightened	overtighten	VBD
overtightened	overtighten	VBN
overtightening	overtighten	VBG
overtightens	overtighten	VBZ
paganise	paganise	VB
paganise	paganise	VBP
paganised	paganise	VBD
paganised	paganise	VBN
paganises	paganise	VBZ
paganising	paganise	VBG
paganize	paganize	VB
paganize	paganize	VBP
paganized	paganize	VBD
paganized	paganize	VBN
paganizes	paganize	VBZ
paganizing	paganize	VBG
page-turner	page-turner	NN
page-turners	page-turner	NNS
palletize	palletize	VB
palletize	palletize	VBP
palletized	palletize	VBD
palletized	palletize	VBN
palletizes	palletize	VBZ
palletizing	palletize	VBG
panopticon	panopticon	NN
panopticons	panopticon	NNS
paper	paper	NN
parallelise	parallelise	VB
parallelise	parallelise	VBP
parallelised	parallelise	VBD
parallelised	parallelise	VBN
parallelises	parallelise	VBZ
parallelising	parallelise	VBG
parameterise	parameterise	VB
parameterise	parameterise	VBP
parameterised	parameterise	VBD
parameterised	parameterise	VBN
parameterises	parameterise	VBZ
parameterising	parameterise	VBG
parameterize	parameterize	VB
parameterize	parameterize	VBP
parameterized	parameterize	VBD
parameterized	parameterize	VBN
parameterizes	parameterize	VBZ
parameterizing	parameterize	VBG
parametrisation	parametrisation	NN:UN
parametrize	parametrize	VB
parametrize	parametrize	VBP
parametrized	parametrize	VBD
parametrized	parametrize	VBN
parametrizes	parametrize	VBZ
parametrizing	parametrize	VBG
parasitise	parasitise	VB
parasitise	parasitise	VBP
parasitised	parasitise	VBD
parasitised	parasitise	VBN
parasitises	parasitise	VBZ
parasitising	parasitise	VBG
parasitize	parasitize	VB
parasitize	parasitize	VBP
parasitized	parasitize	VBD
parasitized	parasitize	VBN
parasitizes	parasitize	VBZ
parasitizing	parasitize	VBG
parenthesise	parenthesise	VB
parenthesise	parenthesise	VBP
parenthesised	parenthesise	VBD
parenthesised	parenthesise	VBN
parenthesises	parenthesise	VBZ
parenthesising	parenthesise	VBG
partialise	partialise	VB
partialise	partialise	VBP
partialised	partialise	VBD
partialised	partialise	VBN
partialises	partialise	VBZ
partialising	partialise	VBG
partialize	partialize	VB
partialize	partialize	VBP
partialized	partialize	VBD
partialized	partialize	VBN
partializes	partialize	VBZ
partializing	partialize	VBG
passing	passing	JJ
passivate	passivate	VB
passivate	passivate	VBP
passivated	passivate	VBD
passivated	passivate	VBN
passivates	passivate	VBZ
passivating	passivate	VBG
passivisation	passivisation	NN:UN
passivisations	passivisation	NNS
passivise	passivise	VB
passivise	passivise	VBP
passivised	passivise	VBD
passivised	passivise	VBN
passivises	passivise	VBZ
passivising	passivise	VBG
passivization	passivization	NN:UN
passivize	passivize	VB
passivize	passivize	VBP
passivized	passivize	VBD
passivized	passivize	VBN
passivizes	passivize	VBZ
passivizing	passivize	VBG
passphrase	passphrase	NN
passphrases	passphrase	NNS
pathologise	pathologise	VB
pathologise	pathologise	VBP
pathologised	pathologise	VBD
pathologised	pathologise	VBN
pathologises	pathologise	VBZ
pathologising	pathologise	VBG
pathologize	pathologize	VB
pathologize	pathologize	VBP
pathologized	pathologize	VBD
pathologized	pathologize	VBN
pathologizes	pathologize	VBZ
pathologizing	pathologize	VBG
patronising	patronise	VBG
PayPal	PayPal	NNP
pearlise	pearlise	VB
pearlise	pearlise	VBP
pearlised	pearlise	VBD
pearlised	pearlise	VBN
pearlises	pearlise	VBZ
pearlising	pearlise	VBG
pearlize	pearlize	VB
pearlize	pearlize	VBP
pearlized	pearlize	VBD
pearlized	pearlize	VBN
pearlizes	pearlize	VBZ
pearlizing	pearlize	VBG
Pendle	Pendle	NNP
perfume	perfume	NN
periodise	periodise	VB
periodise	periodise	VBP
periodised	periodise	VBD
periodised	periodise	VBN
periodises	periodise	VBZ
periodising	periodise	VBG
periodize	periodize	VB
periodize	periodize	VBP
periodized	periodize	VBD
periodized	periodize	VBN
periodizes	periodize	VBZ
periodizing	periodize	VBG
peripheralise	peripheralise	VB
peripheralise	peripheralise	VBP
peripheralised	peripheralise	VBD
peripheralised	peripheralise	VBN
peripheralises	peripheralise	VBZ
peripheralising	peripheralise	VBG
peripheralize	peripheralize	VB
peripheralize	peripheralize	VBP
peripheralized	peripheralize	VBD
peripheralized	peripheralize	VBN
peripheralizes	peripheralize	VBZ
peripheralizing	peripheralize	VBG
petaampere	petaampere	NN
petaamperes	petaampere	NNS
petabecquerel	petabecquerel	NN
petabecquerels	petabecquerel	NNS
petacandela	petacandela	NN
petacandelas	petacandela	NNS
petacoulomb	petacoulomb	NN
petacoulombs	petacoulomb	NNS
petafarad	petafarad	NN
petafarads	petafarad	NNS
petagram	petagram	NN
petagramme	petagramme	NN
petagrammes	petagramme	NNS
petagrams	petagram	NNS
petagray	petagray	NN
petagrays	petagray	NNS
petahenries	petahenry	NNS
petahenry	petahenry	NN
petahertz	petahertz	NN
petahertz	petahertz	NNS
petajoule	petajoule	NN
petajoules	petajoule	NNS
petakatal	petakatal	NN
petakatals	petakatal	NNS
petakelvin	petakelvin	NN
petakelvins	petakelvin	NNS
petaliter	petaliter	NN
petaliters	petaliter	NNS
petalitre	petalitre	NN
petalitres	petalitre	NNS
petalumen	petalumen	NN
petalumens	petalumen	NNS
petalux	petalux	NN
petalux	petalux	NNS
petameter	petameter	NN
petameters	petameter	NNS
petametre	petametre	NN
petametres	petametre	NNS
petamole	petamole	NN
petamoles	petamole	NNS
petanewton	petanewton	NN
petanewtons	petanewton	NNS
petaohm	petaohm	NN
petaohms	petaohm	NNS
petapascal	petapascal	NN
petapascals	petapascal	NNS
petaradian	petaradian	NN
petaradians	petaradian	NNS
petasiemens	petasiemens	NN
petasiemens	petasiemens	NNS
petasievert	petasievert	NN
petasieverts	petasievert	NNS
petasteradian	petasteradian	NN
petasteradians	petasteradian	NNS
petatesla	petatesla	NN
petateslas	petatesla	NNS
petavolt	petavolt	NN
petavolts	petavolt	NNS
petawatt	petawatt	NN
petawatts	petawatt	NNS
petaweber	petaweber	NN
petawebers	petaweber	NNS
petrified	petrified	JJ
phonemicise	phonemicise	VB
phonemicise	phonemicise	VBP
phonemicised	phonemicise	VBD
phonemicised	phonemicise	VBN
phonemicises	phonemicise	VBZ
phonemicising	phonemicise	VBG
phonemicize	phonemicize	VB
phonemicize	phonemicize	VBP
phonemicized	phonemicize	VBD
phonemicized	phonemicize	VBN
phonemicizes	phonemicize	VBZ
phonemicizing	phonemicize	VBG
photoionise	photoionise	VB
photoionise	photoionise	VBP
photoionised	photoionise	VBD
photoionised	photoionise	VBN
photoionises	photoionise	VBZ
photoionising	photoionise	VBG
photoionize	photoionize	VB
photoionize	photoionize	VBP
photoionized	photoionize	VBD
photoionized	photoionize	VBN
photoionizes	photoionize	VBZ
photoionizing	photoionize	VBG
photosensitisation	photosensitisation	NN:UN
photosensitise	photosensitise	VB
photosensitise	photosensitise	VBP
photosensitised	photosensitise	VBD
photosensitised	photosensitise	VBN
photosensitises	photosensitise	VBZ
photosensitising	photosensitise	VBG
photosynthesise	photosynthesise	VB
photosynthesise	photosynthesise	VBP
photosynthesised	photosynthesise	VBD
photosynthesised	photosynthesise	VBN
photosynthesises	photosynthesise	VBZ
picoampere	picoampere	NN
picoamperes	picoampere	NNS
picobecquerel	picobecquerel	NN
picobecquerels	picobecquerel	NNS
picocandela	picocandela	NN
picocandelas	picocandela	NNS
picocoulomb	picocoulomb	NN
picocoulombs	picocoulomb	NNS
picogramme	picogramme	NN
picogrammes	picogramme	NNS
picogray	picogray	NN
picograys	picogray	NNS
picohenries	picohenry	NNS
picohenry	picohenry	NN
picohertz	picohertz	NN
picohertz	picohertz	NNS
picojoule	picojoule	NN
picojoules	picojoule	NNS
picokatal	picokatal	NN
picokatals	picokatal	NNS
picokelvin	picokelvin	NN
picokelvins	picokelvin	NNS
picoliter	picoliter	NN
picoliters	picoliter	NNS
picolitre	picolitre	NN
picolitres	picolitre	NNS
picolumen	picolumen	NN
picolumens	picolumen	NNS
picolux	picolux	NN
picolux	picolux	NNS
picometers	picometer	NNS
picometres	picometre	NNS
piconewton	piconewton	NN
piconewtons	piconewton	NNS
picoohm	picoohm	NN
picoohms	picoohm	NNS
picopascal	picopascal	NN
picopascals	picopascal	NNS
picoradian	picoradian	NN
picoradians	picoradian	NNS
picosiemens	picosiemens	NN
picosiemens	picosiemens	NNS
picosievert	picosievert	NN
picosieverts	picosievert	NNS
picosteradian	picosteradian	NN
picosteradians	picosteradian	NNS
picotesla	picotesla	NN
picoteslas	picotesla	NNS
picovolt	picovolt	NN
picovolts	picovolt	NNS
picowatts	picowatt	NNS
picoweber	picoweber	NN
picowebers	picoweber	NNS
piledriver	piledriver	NN
piledrivers	piledriver	NNS
pitot	pitot	NN
pitots	pitot	NNS
plastic	plastic	NN
plugin	plugin	NN
plugins	plugin	NNS
podcast	podcast	NN
podcast	podcast	VB
podcast	podcast	VBD
podcast	podcast	VBN
podcast	podcast	VBP
podcasting	podcast	VBG
podcasts	podcast	NNS
podcasts	podcast	VBZ
poison	poison	NN
poppy	poppy	NN
potentise	potentise	VB
potentise	potentise	VBP
potentised	potentise	VBD
potentised	potentise	VBN
potentises	potentise	VBZ
potentising	potentise	VBG
potentize	potentize	VB
potentize	potentize	VBP
potentized	potentize	VBD
potentized	potentize	VBN
potentizes	potentize	VBZ
potentizing	potentize	VBG
potlife	potlife	NN
potlives	potlife	NNS
prearrival	prearrival	JJ
predefine	predefine	VB
predefine	predefine	VBP
predefined	predefine	VBD
predefined	predefine	VBN
predefines	predefine	VBZ
predefining	predefine	VBG
prejudiced	prejudiced	JJ
preload	preload	VB
preload	preload	VBP
preloaded	preload	VBD
preloaded	preload	VBN
preloading	preload	VBG
preloads	preload	VBZ
preowned	preowned	JJ
pressurisation	pressurisation	NN:UN
pressuriser	pressuriser	NN
pressurisers	pressuriser	NNS
preventatively	preventatively	RB
preventible	preventible	JJ
prickly	prickly	JJ
probing	probing	JJ
problematise	problematise	VB
problematise	problematise	VBP
problematised	problematise	VBD
problematised	problematise	VBN
problematises	problematise	VBZ
problematising	problematise	VBG
problematize	problematize	VB
problematize	problematize	VBP
problematized	problematize	VBD
problematized	problematize	VBN
problematizes	problematize	VBZ
problematizing	problematize	VBG
productionise	productionise	VB
productionise	productionise	VBP
productionised	productionise	VBD
productionised	productionise	VBN
productionises	productionise	VBZ
productionising	productionise	VBG
productionize	productionize	VB
productionize	productionize	VBP
productionized	productionize	VBD
productionized	productionize	VBN
productionizes	productionize	VBZ
productionizing	productionize	VBG
productisation	productisation	NN:U
productization	productization	NN:U
productize	productize	VB
productize	productize	VBP
productized	productize	VBD
productized	productize	VBN
productizes	productize	VBZ
productizing	productize	VBG
provincialisation	provincialisation	NN:UN
pushbuttons	pushbutton	NNS
quantize	quantize	VB
quantize	quantize	VBP
quantized	quantize	VBD
quantized	quantize	VBN
quantizes	quantize	VBZ
quantizing	quantize	VBG
rale	rale	NN
rales	rale	NNS
rasterise	rasterise	VB
rasterise	rasterise	VBP
rasterised	rasterise	VBD
rasterised	rasterise	VBN
rasterises	rasterise	VBZ
rasterising	rasterise	VBG
rasterization	rasterization	NN:UN
rasterize	rasterize	VB
rasterize	rasterize	VBP
rasterized	rasterize	VBD
rasterized	rasterize	VBN
rasterizes	rasterize	VBZ
rasterizing	rasterize	VBG
reaccept	reaccept	VB
reaccept	reaccept	VBP
reaccepted	reaccept	VBD
reaccepted	reaccept	VBN
reaccepting	reaccept	VBG
reaccepts	reaccept	VBZ
readvertise	readvertise	VB
readvertise	readvertise	VBP
readvertised	readvertise	VBD
readvertised	readvertise	VBN
readvertises	readvertise	VBZ
readvertising	readvertise	VBG
reargue	reargue	VB
reargue	reargue	VBP
reargued	reargue	VBD
reargued	reargue	VBN
reargues	reargue	VBZ
rearguing	reargue	VBG
reclothe	reclothe	VB
reclothe	reclothe	VBP
reclothed	reclothe	VBD
reclothed	reclothe	VBN
reclothes	reclothe	VBZ
reclothing	reclothe	VBG
recoin	recoin	VB
recoin	recoin	VBP
recoined	recoin	VBD
recoined	recoin	VBN
recoining	recoin	VBG
recoins	recoin	VBZ
recompound	recompound	VB
recompound	recompound	VBP
recompounded	recompound	VBD
recompounded	recompound	VBN
recompounding	recompound	VBG
recompounds	recompound	VBZ
reconceptualise	reconceptualise	VB
reconceptualise	reconceptualise	VBP
reconceptualised	reconceptualise	VBD
reconceptualised	reconceptualise	VBN
reconceptualises	reconceptualise	VBZ
reconceptualising	reconceptualise	VBG
reconceptualize	reconceptualize	VB
reconceptualize	reconceptualize	VBP
reconceptualized	reconceptualize	VBD
reconceptualized	reconceptualize	VBN
reconceptualizes	reconceptualize	VBZ
reconceptualizing	reconceptualize	VBG
recontextualise	recontextualise	VB
recontextualise	recontextualise	VBP
recontextualised	recontextualise	VBD
recontextualised	recontextualise	VBN
recontextualises	recontextualise	VBZ
recontextualising	recontextualise	VBG
recontextualize	recontextualize	VB
recontextualize	recontextualize	VBP
recontextualized	recontextualize	VBD
recontextualized	recontextualize	VBN
recontextualizes	recontextualize	VBZ
recontextualizing	recontextualize	VBG
recrystallisation	recrystallisation	NN:UN
redemand	redemand	VB
redemand	redemand	VBP
redemanded	redemand	VBD
redemanded	redemand	VBN
redemanding	redemand	VBG
redemands	redemand	VBZ
redrill	redrill	VB
redrill	redrill	VBP
redrilled	redrill	VBD
redrilled	redrill	VBN
redrilling	redrill	VBG
redrills	redrill	VBZ
reexpress	reexpress	VB
reexpress	reexpress	VBP
reexpressed	reexpress	VBD
reexpressed	reexpress	VBN
reexpresses	reexpress	VBZ
reexpressing	reexpress	VBG
refire	refire	VB
refire	refire	VBP
refired	refire	VBD
refired	refire	VBN
refires	refire	VBZ
refiring	refire	VBG
reflow	reflow	VB
reflow	reflow	VBP
reflowed	reflow	VBD
reflowed	reflow	VBN
reflowing	reflow	VBG
reflows	reflow	VBZ
reframe	reframe	VB
reframe	reframe	VBP
reframed	reframe	VBD
reframed	reframe	VBN
reframes	reframe	VBZ
reframing	reframe	VBG
regarding	regarding	IN
regionalise	regionalise	VB
regionalise	regionalise	VBP
regionalised	regionalise	VBD
regionalised	regionalise	VBN
regionalises	regionalise	VBZ
regionalising	regionalise	VBG
regionalize	regionalize	VB
regionalize	regionalize	VBP
regionalized	regionalize	VBD
regionalized	regionalize	VBN
regionalizes	regionalize	VBZ
regionalizing	regionalize	VBG
rehandle	rehandle	VB
rehandle	rehandle	VBP
rehandled	rehandle	VBD
rehandled	rehandle	VBN
rehandles	rehandle	VBZ
rehandling	rehandle	VBG
reinflate	reinflate	VB
reinflate	reinflate	VBP
reinflated	reinflate	VBD
reinflated	reinflate	VBN
reinflates	reinflate	VBZ
reinflating	reinflate	VBG
reinform	reinform	VB
reinform	reinform	VBP
reinformed	reinform	VBD
reinformed	reinform	VBN
reinforming	reinform	VBG
reinforms	reinform	VBZ
reinvite	reinvite	VB
reinvite	reinvite	VBP
reinvited	reinvite	VBD
reinvited	reinvite	VBN
reinvites	reinvite	VBZ
reinviting	reinvite	VBG
relativise	relativise	VB
relativise	relativise	VBP
relativised	relativise	VBD
relativised	relativise	VBN
relativises	relativise	VBZ
relativising	relativise	VBG
relativize	relativize	VB
relativize	relativize	VBP
relativized	relativize	VBD
relativized	relativize	VBN
relativizes	relativize	VBZ
relativizing	relativize	VBG
relet	relet	VB
relet	relet	VBD
relet	relet	VBN
relet	relet	VBP
relets	relet	VBZ
reletting	relet	VBG
remaster	remaster	VB
remaster	remaster	VBP
remastered	remaster	VBD
remastered	remaster	VBN
remastering	remaster	VBG
remasters	remaster	VBZ
rematerialise	rematerialise	VB
rematerialise	rematerialise	VBP
rematerialised	rematerialise	VBD
rematerialised	rematerialise	VBN
rematerialises	rematerialise	VBZ
rematerialising	rematerialise	VBG
rematerialize	rematerialize	VB
rematerialize	rematerialize	VBP
rematerialized	rematerialize	VBD
rematerialized	rematerialize	VBN
rematerializes	rematerialize	VBZ
rematerializing	rematerialize	VBG
renationalize	renationalize	VB
renationalize	renationalize	VBP
renationalized	renationalize	VBD
renationalized	renationalize	VBN
renationalizes	renationalize	VBZ
renationalizing	renationalize	VBG
repass	repass	VB
repass	repass	VBP
repassed	repass	VBD
repassed	repass	VBN
repasses	repass	VBZ
repassing	repass	VBG
replan	replan	VB
replan	replan	VBP
replanned	replan	VBD
replanned	replan	VBN
replanning	replan	VBG
replans	replan	VBZ
repressurisation	repressurisation	NN:U
repressurise	repressurise	VB
repressurise	repressurise	VBP
repressurised	repressurise	VBD
repressurised	repressurise	VBN
repressurises	repressurise	VBZ
repressurising	repressurise	VBG
repressurization	repressurization	NN:U
repressurize	repressurize	VB
repressurize	repressurize	VBP
repressurized	repressurize	VBD
repressurized	repressurize	VBN
repressurizes	repressurize	VBZ
repressurizing	repressurize	VBG
reprogrammable	reprogrammable	JJ
restabilise	restabilise	VB
restabilise	restabilise	VBP
restabilised	restabilise	VBD
restabilised	restabilise	VBN
restabilises	restabilise	VBZ
restabilising	restabilise	VBG
restabilize	restabilize	VB
restabilize	restabilize	VBP
restabilized	restabilize	VBD
restabilized	restabilize	VBN
restabilizes	restabilize	VBZ
restabilizing	restabilize	VBG
restage	restage	VB
restage	restage	VBP
restaged	restage	VBD
restaged	restage	VBN
restages	restage	VBZ
restaging	restage	VBG
restamp	restamp	VB
restamp	restamp	VBP
restamped	restamp	VBD
restamped	restamp	VBN
restamping	restamp	VBG
restamps	restamp	VBZ
Restormel	Restormel	NNP
rethread	rethread	VB
rethread	rethread	VBP
rethreaded	rethread	VBD
rethreaded	rethread	VBN
rethreading	rethread	VBG
rethreads	rethread	VBZ
retractive	retractive	JJ
retractive	retractive	NN
retractives	retractive	NNS
retrograde	retrograde	JJ
retune	retune	VB
retune	retune	VBP
retuned	retune	VBD
retuned	retune	VBN
retunes	retune	VBZ
retuning	retune	VBG
revolutionary	revolutionary	JJ
rework	rework	NN:UN
reworks	rework	NNS
rewrap	rewrap	VB
rewrap	rewrap	VBP
rewrapped	rewrap	VBD
rewrapped	rewrap	VBN
rewrapping	rewrap	VBG
rewraps	rewrap	VBZ
ringfence	ringfence	VB
ringfence	ringfence	VBP
ringfenced	ringfence	VBD
ringfenced	ringfence	VBN
ringfences	ringfence	VBZ
ringfencing	ringfence	VBG
riverfront	riverfront	NN
Rivne	Rivne	NNP
robotic	robotic	JJ
Rochford	Rochford	NNP
rope	rope	NN
ruralise	ruralise	VB
ruralise	ruralise	VBP
ruralised	ruralise	VBD
ruralised	ruralise	VBN
ruralises	ruralise	VBZ
ruralising	ruralise	VBG
ruralize	ruralize	VB
ruralize	ruralize	VBP
ruralized	ruralize	VBD
ruralized	ruralize	VBN
ruralizes	ruralize	VBZ
ruralizing	ruralize	VBG
Rushcliffe	Rushcliffe	NNP
safetied	safety	VBD
safetied	safety	VBN
safeties	safety	VBZ
safety	safety	VB
safety	safety	VBP
safetying	safety	VBG
Sanforised	Sanforised	JJ
Sanforize	Sanforize	VB
Sanforize	Sanforize	VBP
Sanforized	Sanforize	VBD
Sanforized	Sanforize	VBN
Sanforized	Sanforized	JJ
Sanforizes	Sanforize	VBZ
Sanforizing	Sanforize	VBG
sanitiser	sanitiser	NN
sanitisers	sanitiser	NNS
satirisers	satiriser	NNS
SATURDAY	Saturday	NNP
schematise	schematise	VB
schematise	schematise	VBP
schematised	schematise	VBD
schematised	schematise	VBN
schematises	schematise	VBZ
schematising	schematise	VBG
Schematron	Schematron	NNP
sclerotise	sclerotise	VB
sclerotise	sclerotise	VBP
sclerotised	sclerotise	VBD
sclerotised	sclerotise	VBN
sclerotises	sclerotise	VBZ
sclerotising	sclerotise	VBG
sclerotize	sclerotize	VB
sclerotize	sclerotize	VBP
sclerotized	sclerotize	VBD
sclerotized	sclerotize	VBN
sclerotizes	sclerotize	VBZ
sclerotizing	sclerotize	VBG
screencast	screencast	NN
screencasts	screencast	NNS
screenful	screenful	NN:U
screwjack	screwjack	NN
screwjacks	screwjack	NNS
sealant	sealant	NN:UN
sectarianise	sectarianise	VB
sectarianise	sectarianise	VBP
sectarianised	sectarianise	VBD
sectarianised	sectarianise	VBN
sectarianises	sectarianise	VBZ
sectarianising	sectarianise	VBG
sectarianize	sectarianize	VB
sectarianize	sectarianize	VBP
sectarianized	sectarianize	VBD
sectarianized	sectarianize	VBN
sectarianizes	sectarianize	VBZ
sectarianizing	sectarianize	VBG
sectorisation	sectorisation	NN:U
sectorization	sectorization	NN:U
securitise	securitise	VB
securitise	securitise	VBP
securitised	securitise	VBD
securitised	securitise	VBN
securitises	securitise	VBZ
securitising	securitise	VBG
securitize	securitize	VB
securitize	securitize	VBP
securitized	securitize	VBD
securitized	securitize	VBN
securitizes	securitize	VBZ
securitizing	securitize	VBG
semiautonomous	semiautonomous	JJ
sensualise	sensualise	VB
sensualise	sensualise	VBP
sensualised	sensualise	VBD
sensualised	sensualise	VBN
sensualises	sensualise	VBZ
sensualising	sensualise	VBG
SEPTEMBER	September	NNP
servicing	servicing	NN:U
servicings	servicing	NNS
seventeenfold	seventeenfold	JJ
seventeenfold	seventeenfold	RB
sexualise	sexualise	VB
sexualise	sexualise	VBP
sexualised	sexualise	VBD
sexualised	sexualise	VBN
sexualises	sexualise	VBZ
sexualising	sexualise	VBG
sexualize	sexualize	VB
sexualize	sexualize	VBP
sexualized	sexualize	VBD
sexualized	sexualize	VBN
sexualizes	sexualize	VBZ
sexualizing	sexualize	VBG
shampoo	shampoo	NN
shapely	shapely	JJ
shoreside	shoreside	JJ
shortlist	shortlist	NN
shortlists	shortlist	NNS
sideslip	sideslip	VB
sideslip	sideslip	VBP
sideslipped	sideslip	VBD
sideslipped	sideslip	VBN
sideslipping	sideslip	VBG
sideslips	sideslip	VBZ
signalisation	signalisation	NN:U
sixteenfold	sixteenfold	JJ
sixteenfold	sixteenfold	RB
Skype	Skype	NNP
slantways	slantways	RB
sloganise	sloganise	VB
sloganise	sloganise	VBP
sloganised	sloganise	VBD
sloganised	sloganise	VBN
sloganises	sloganise	VBZ
sloganising	sloganise	VBG
sloganize	sloganize	VB
sloganize	sloganize	VBP
sloganized	sloganize	VBD
sloganized	sloganize	VBN
sloganizes	sloganize	VBZ
sloganizing	sloganize	VBG
smackdown	smackdown	NN
smartphone	smartphone	NN
smartphones	smartphone	NNS
soap	soap	NN
socialisers	socialiser	NNS
sodomisation	sodomisation	NN:U
sodomization	sodomization	NN:U
solarise	solarise	VB
solarise	solarise	VBP
solarised	solarise	VBD
solarised	solarise	VBN
solarises	solarise	VBZ
solarising	solarise	VBG
solarize	solarize	VB
solarize	solarize	VBP
solarized	solarize	VBD
solarized	solarize	VBN
solarizes	solarize	VBZ
solarizing	solarize	VBG
solecise	solecise	VB
solecise	solecise	VBP
solecised	solecise	VBD
solecised	solecise	VBN
solecises	solecise	VBZ
solecising	solecise	VBG
solecize	solecize	VB
solecize	solecize	VBP
solecized	solecize	VBD
solecized	solecize	VBN
solecizes	solecize	VBZ
solecizing	solecize	VBG
spam	spam	VB
spam	spam	VBP
spammed	spam	VBD
spammed	spam	VBN
spamming	spam	VBG
spams	spam	VBZ
spanwise	spanwise	RB
sparkling	sparkling	JJ
species	species	NNS
speedbrake	speedbrake	NN
speedbrakes	speedbrake	NNS
Spicer	Spicer	NNP
spiritualise	spiritualise	VB
spiritualise	spiritualise	VBP
spiritualised	spiritualise	VBD
spiritualised	spiritualise	VBN
spiritualises	spiritualise	VBZ
spiritualising	spiritualise	VBG
spiritualize	spiritualize	VB
spiritualize	spiritualize	VBP
spiritualized	spiritualize	VBD
spiritualized	spiritualize	VBN
spiritualizes	spiritualize	VBZ
spiritualizing	spiritualize	VBG
splenectomise	splenectomise	VB
splenectomise	splenectomise	VBP
splenectomised	splenectomise	VBD
splenectomised	splenectomise	VBN
splenectomises	splenectomise	VBZ
splenectomising	splenectomise	VBG
splenectomize	splenectomize	VB
splenectomize	splenectomize	VBP
splenectomized	splenectomize	VBD
splenectomized	splenectomize	VBN
splenectomizes	splenectomize	VBZ
splenectomizing	splenectomize	VBG
splined	splined	JJ
standing	standing	JJ
statin	statin	NN:UN
statins	statin	NNS
Steinhardt	Steinhardt	NNP
stimulating	stimulating	JJ
strategise	strategise	VB
strategise	strategise	VBP
strategised	strategise	VBD
strategised	strategise	VBN
strategises	strategise	VBZ
strategising	strategise	VBG
strategize	strategize	VB
strategize	strategize	VBP
strategized	strategize	VBD
strategized	strategize	VBN
strategizes	strategize	VBZ
strategizing	strategize	VBG
strength	strength	NN
subfolder	subfolder	NN
subfolders	subfolder	NNS
subsidiser	subsidiser	NN
subsidisers	subsidiser	NNS
subtextual	subtextual	JJ
subvocalisation	subvocalisation	NN:UN
subvocalisations	subvocalisation	NNS
subvocalise	subvocalise	VB
subvocalise	subvocalise	VBP
subvocalised	subvocalise	VBD
subvocalised	subvocalise	VBN
subvocalises	subvocalise	VBZ
subvocalising	subvocalise	VBG
subvocalize	subvocalize	VB
subvocalize	subvocalize	VBP
subvocalized	subvocalize	VBD
subvocalized	subvocalize	VBN
subvocalizes	subvocalize	VBZ
subvocalizing	subvocalize	VBG
summarisations	summarisation	NNS
SUNDAY	Sunday	NNP
supermicron	supermicron	JJ
swinging	swinging	JJ
Symbian	Symbian	NNP
synergise	synergise	VB
synergise	synergise	VBP
synergised	synergise	VBD
synergised	synergise	VBN
synergises	synergise	VBZ
synergising	synergise	VBG
synergize	synergize	VB
synergize	synergize	VBP
synergized	synergize	VBD
synergized	synergize	VBN
synergizes	synergize	VBZ
synergizing	synergize	VBG
systematical	systematical	JJ
systemise	systemise	VB
systemise	systemise	VBP
systemised	systemise	VBD
systemised	systemise	VBN
systemises	systemise	VBZ
systemising	systemise	VBG
Tandridge	Tandridge	NNP
taskbars	taskbar	NNS
Teesdale	Teesdale	NNP
Teignbridge	Teignbridge	NNP
telepathise	telepathise	VB
telepathise	telepathise	VBP
telepathised	telepathise	VBD
telepathised	telepathise	VBN
telepathises	telepathise	VBZ
telepathising	telepathise	VBG
temporising	temporise	VBG
teraampere	teraampere	NN
teraamperes	teraampere	NNS
terabecquerel	terabecquerel	NN
terabecquerels	terabecquerel	NNS
teracandela	teracandela	NN
teracandelas	teracandela	NNS
teracoulomb	teracoulomb	NN
teracoulombs	teracoulomb	NNS
terafarad	terafarad	NN
terafarads	terafarad	NNS
teragram	teragram	NN
teragramme	teragramme	NN
teragrammes	teragramme	NNS
teragrams	teragram	NNS
teragray	teragray	NN
teragrays	teragray	NNS
terahenries	terahenry	NNS
terahenry	terahenry	NN
terahertz	terahertz	NNS
terajoule	terajoule	NN
terajoules	terajoule	NNS
terakatal	terakatal	NN
terakatals	terakatal	NNS
terakelvin	terakelvin	NN
terakelvins	terakelvin	NNS
teraliter	teraliter	NN
teraliters	teraliter	NNS
teralitre	teralitre	NN
teralitres	teralitre	NNS
teralumen	teralumen	NN
teralumens	teralumen	NNS
teralux	teralux	NN
teralux	teralux	NNS
terameter	terameter	NN
terameters	terameter	NNS
terametre	terametre	NN
terametres	terametre	NNS
teramole	teramole	NN
teramoles	teramole	NNS
teranewton	teranewton	NN
teranewtons	teranewton	NNS
terapascal	terapascal	NN
terapascals	terapascal	NNS
teraradian	teraradian	NN
teraradians	teraradian	NNS
terasiemens	terasiemens	NN
terasiemens	terasiemens	NNS
terasievert	terasievert	NN
terasieverts	terasievert	NNS
terasteradian	terasteradian	NN
terasteradians	terasteradian	NNS
teratesla	teratesla	NN
terateslas	teratesla	NNS
teravolt	teravolt	NN
teravolts	teravolt	NNS
teraweber	teraweber	NN
terawebers	teraweber	NNS
termbase	termbase	NN
termbases	termbase	NNS
Ternopil	Ternopil	NNP
tesseract	tesseract	NN
tesseracts	tesseract	NNS
testing	testing	JJ
texturise	texturise	VB
texturise	texturise	VBP
texturised	texturise	VBD
texturised	texturise	VBN
texturises	texturise	VBZ
texturising	texturise	VBG
texturize	texturize	VB
texturize	texturize	VBP
texturized	texturize	VBD
texturized	texturize	VBN
texturizes	texturize	VBZ
texturizing	texturize	VBG
thematise	thematise	VB
thematise	thematise	VBP
thematised	thematise	VBD
thematised	thematise	VBN
thematises	thematise	VBZ
thematising	thematise	VBG
thematize	thematize	VB
thematize	thematize	VBP
thematized	thematize	VBD
thematized	thematize	VBN
thematizes	thematize	VBZ
thematizing	thematize	VBG
thereunto	thereunto	RB
think	think	NN
thinning	thinning	JJ
thread	thread	NN
Thrush	Thrush	NNP
THURSDAY	Thursday	NNP
tintype	tintype	NN
tokenisation	tokenisation	NN:UN
tokenisations	tokenisation	NNS
tokenization	tokenization	NN:UN
tokenizations	tokenization	NNS
tooltip	tooltip	NN
tooltips	tooltip	NNS
topicalise	topicalise	VB
topicalise	topicalise	VBP
topicalised	topicalise	VBD
topicalised	topicalise	VBN
topicalises	topicalise	VBZ
topicalising	topicalise	VBG
topicalize	topicalize	VB
topicalize	topicalize	VBP
topicalized	topicalize	VBD
topicalized	topicalize	VBN
topicalizes	topicalize	VBZ
topicalizing	topicalize	VBG
Torfaen	Torfaen	NNP
torqueing	torque	VBG
totalise	totalise	VB
totalise	totalise	VBP
totalised	totalise	VBD
totalised	totalise	VBN
totalises	totalise	VBZ
totalising	totalise	VBG
totalize	totalize	VB
totalize	totalize	VBP
totalized	totalize	VBD
totalized	totalize	VBN
totalizes	totalize	VBZ
totalizing	totalize	VBG
touchpoint	touchpoint	NN
touchpoints	touchpoint	NNS
towtruck	towtruck	NN
towtrucks	towtruck	NNS
tranquillisation	tranquillisation	NN:U
tranquillization	tranquillization	NN:U
traumatisation	traumatisation	NN:UN
traumatisations	traumatisation	NNS
traveled	traveled	JJ
traveling	traveling	JJ
travelling	travelling	JJ
TUESDAY	Tuesday	NNP
Tynedale	Tynedale	NNP
typewritten	typewritten	JJ
ullaging	ullaging	NN:U
unclose	unclose	VB
unclose	unclose	VBP
unclosed	unclose	VBD
unclosed	unclose	VBN
unclosed	unclosed	JJ
uncloses	unclose	VBZ
unclosing	unclose	VBG
underheat	underheat	VB
underheat	underheat	VBP
underheated	underheat	VBD
underheated	underheat	VBN
underheating	underheat	VBG
underheats	underheat	VBZ
underperform	underperform	VB
underperform	underperform	VBP
underperformed	underperform	VBD
underperformed	underperform	VBN
underperforming	underperform	VBG
underperforms	underperform	VBZ
underpraise	underpraise	VB
underpraise	underpraise	VBP
underpraised	underpraise	VBD
underpraised	underpraise	VBN
underpraises	underpraise	VBZ
underpraising	underpraise	VBG
undersupplied	undersupply	VBD
undersupplied	undersupply	VBN
undersupplies	undersupply	VBZ
undersupply	undersupply	VB
undersupply	undersupply	VBP
undersupplying	undersupply	VBG
unencrypted	unencrypted	JJ
unforthcoming	unforthcoming	JJ
unimolecular	unimolecular	JJ
uninsulated	uninsulated	JJ
unionize	unionize	VB
unionize	unionize	VBP
unionized	unionize	VBD
unionized	unionize	VBN
unionizes	unionize	VBZ
unionizing	unionize	VBG
unitise	unitise	VB
unitise	unitise	VBP
unitised	unitise	VBD
unitised	unitise	VBN
unitises	unitise	VBZ
unitising	unitise	VBG
unitize	unitize	VB
unitize	unitize	VBP
unitized	unitize	VBD
unitized	unitize	VBN
unitizes	unitize	VBZ
unitizing	unitize	VBG
unlinked	unlinked	JJ
unmistakeable	unmistakeable	JJ
unmoor	unmoor	VB
unmoored	unmoor	VBD
unmoored	unmoor	VBN
unmooring	unmoor	VBG
unmoors	unmoor	VBZ
unpile	unpile	VB
unpile	unpile	VBP
unpiled	unpile	VBD
unpiled	unpile	VBN
unpiles	unpile	VBZ
unpiling	unpile	VBG
unsightly	unsightly	JJ
unsubscribe	unsubscribe	VB
unsubscribe	unsubscribe	VBP
unsubscribed	unsubscribe	VBD
unsubscribed	unsubscribe	VBN
unsubscribes	unsubscribe	VBZ
unsubscribing	unsubscribe	VBG
unwove	unwove	VBD
upset	upset	JJ
upsize	upsize	VB
upsize	upsize	VBP
upsized	upsize	VBD
upsized	upsize	VBN
upsizes	upsize	VBZ
upsizing	upsize	VBG
uralitise	uralitise	VB
uralitise	uralitise	VBP
uralitised	uralitise	VBD
uralitised	uralitise	VBN
uralitises	uralitise	VBZ
uralitising	uralitise	VBG
uralitize	uralitize	VB
uralitize	uralitize	VBP
uralitized	uralitize	VBD
uralitized	uralitize	VBN
uralitizes	uralitize	VBZ
uralitizing	uralitize	VBG
username	username	NN
usernames	username	NNS
vandalisation	vandalisation	NN:U
vascularise	vascularise	VB
vascularise	vascularise	VBP
vascularised	vascularise	VBD
vascularised	vascularise	VBN
vascularises	vascularise	VBZ
vascularising	vascularise	VBG
vascularize	vascularize	VB
vascularize	vascularize	VBP
vascularized	vascularize	VBD
vascularized	vascularize	VBN
vascularizes	vascularize	VBZ
vascularizing	vascularize	VBG
vectorize	vectorize	VB
vectorize	vectorize	VBP
vectorized	vectorize	VBD
vectorized	vectorize	VBN
vectorizes	vectorize	VBZ
vectorizing	vectorize	VBG
verbalisers	verbaliser	NNS
viewport	viewport	NN
viewports	viewport	NNS
Vinnytsia	Vinnytsia	NNP
volumise	volumise	VB
volumise	volumise	VBP
volumised	volumise	VBD
volumised	volumise	VBN
volumises	volumise	VBZ
volumising	volumise	VBG
volumize	volumize	VB
volumize	volumize	VBP
volumized	volumize	VBD
volumized	volumize	VBN
volumizes	volumize	VBZ
volumizing	volumize	VBG
vulcanisers	vulcaniser	NNS
walkthrough	walkthrough	NN
walkthroughs	walkthrough	NNS
wanting	wanting	JJ
watchkeeper	watchkeeper	NN
watchkeepers	watchkeeper	NNS
watchkeeping	watchkeeping	NN:U
webcast	webcast	NN
webcasts	webcast	NNS
webinar	webinar	NN
webinars	webinar	NNS
WEDNESDAY	Wednesday	NNP
weeklong	weeklong	JJ
Westwood	Westwood	NNP
whomever	whomever	WP
widdershins	widdershins	RB
wiki	wiki	NN
Wikipedia	Wikipedia	NNP
wikis	wiki	NNS
wood	wood	NN
WordPress	WordPress	NNP
worksite	worksite	NN
worksites	worksite	NNS
Wychavon	Wychavon	NNP
Wycombe	Wycombe	NNP
XMetaL	XMetaL	NNP
XMLmind	XMLmind	NNP
yoctoampere	yoctoampere	NN
yoctoamperes	yoctoampere	NNS
yoctobecquerel	yoctobecquerel	NN
yoctobecquerels	yoctobecquerel	NNS
yoctocandela	yoctocandela	NN
yoctocandelas	yoctocandela	NNS
yoctocoulomb	yoctocoulomb	NN
yoctocoulombs	yoctocoulomb	NNS
yoctofarad	yoctofarad	NN
yoctofarads	yoctofarad	NNS
yoctogram	yoctogram	NN
yoctogramme	yoctogramme	NN
yoctogrammes	yoctogramme	NNS
yoctograms	yoctogram	NNS
yoctogray	yoctogray	NN
yoctograys	yoctogray	NNS
yoctohenries	yoctohenry	NNS
yoctohenry	yoctohenry	NN
yoctohertz	yoctohertz	NN
yoctohertz	yoctohertz	NNS
yoctojoule	yoctojoule	NN
yoctojoules	yoctojoule	NNS
yoctokatal	yoctokatal	NN
yoctokatals	yoctokatal	NNS
yoctokelvin	yoctokelvin	NN
yoctokelvins	yoctokelvin	NNS
yoctoliter	yoctoliter	NN
yoctoliters	yoctoliter	NNS
yoctolitre	yoctolitre	NN
yoctolitres	yoctolitre	NNS
yoctolumen	yoctolumen	NN
yoctolumens	yoctolumen	NNS
yoctolux	yoctolux	NN
yoctolux	yoctolux	NNS
yoctometer	yoctometer	NN
yoctometers	yoctometer	NNS
yoctometre	yoctometre	NN
yoctometres	yoctometre	NNS
yoctomole	yoctomole	NN
yoctomoles	yoctomole	NNS
yoctonewton	yoctonewton	NN
yoctonewtons	yoctonewton	NNS
yoctoohm	yoctoohm	NN
yoctoohms	yoctoohm	NNS
yoctopascal	yoctopascal	NN
yoctopascals	yoctopascal	NNS
yoctoradian	yoctoradian	NN
yoctoradians	yoctoradian	NNS
yoctosiemens	yoctosiemens	NN
yoctosiemens	yoctosiemens	NNS
yoctosievert	yoctosievert	NN
yoctosieverts	yoctosievert	NNS
yoctosteradian	yoctosteradian	NN
yoctosteradians	yoctosteradian	NNS
yoctotesla	yoctotesla	NN
yoctoteslas	yoctotesla	NNS
yoctovolt	yoctovolt	NN
yoctovolts	yoctovolt	NNS
yoctowatt	yoctowatt	NN
yoctowatts	yoctowatt	NNS
yoctoweber	yoctoweber	NN
yoctowebers	yoctoweber	NNS
yottaampere	yottaampere	NN
yottaamperes	yottaampere	NNS
yottabecquerel	yottabecquerel	NN
yottabecquerels	yottabecquerel	NNS
yottacandela	yottacandela	NN
yottacandelas	yottacandela	NNS
yottacoulomb	yottacoulomb	NN
yottacoulombs	yottacoulomb	NNS
yottafarad	yottafarad	NN
yottafarads	yottafarad	NNS
yottagram	yottagram	NN
yottagramme	yottagramme	NN
yottagrammes	yottagramme	NNS
yottagrams	yottagram	NNS
yottagray	yottagray	NN
yottagrays	yottagray	NNS
yottahenries	yottahenry	NNS
yottahenry	yottahenry	NN
yottahertz	yottahertz	NN
yottahertz	yottahertz	NNS
yottajoule	yottajoule	NN
yottajoules	yottajoule	NNS
yottakatal	yottakatal	NN
yottakatals	yottakatal	NNS
yottakelvin	yottakelvin	NN
yottakelvins	yottakelvin	NNS
yottaliter	yottaliter	NN
yottaliters	yottaliter	NNS
yottalitre	yottalitre	NN
yottalitres	yottalitre	NNS
yottalumen	yottalumen	NN
yottalumens	yottalumen	NNS
yottalux	yottalux	NN
yottalux	yottalux	NNS
yottameter	yottameter	NN
yottameters	yottameter	NNS
yottametre	yottametre	NN
yottametres	yottametre	NNS
yottamole	yottamole	NN
yottamoles	yottamole	NNS
yottanewton	yottanewton	NN
yottanewtons	yottanewton	NNS
yottaohm	yottaohm	NN
yottaohms	yottaohm	NNS
yottapascal	yottapascal	NN
yottapascals	yottapascal	NNS
yottaradian	yottaradian	NN
yottaradians	yottaradian	NNS
yottasiemens	yottasiemens	NN
yottasiemens	yottasiemens	NNS
yottasievert	yottasievert	NN
yottasieverts	yottasievert	NNS
yottasteradian	yottasteradian	NN
yottasteradians	yottasteradian	NNS
yottatesla	yottatesla	NN
yottateslas	yottatesla	NNS
yottavolt	yottavolt	NN
yottavolts	yottavolt	NNS
yottawatt	yottawatt	NN
yottawatts	yottawatt	NNS
yottaweber	yottaweber	NN
yottawebers	yottaweber	NNS
YouTube	YouTube	NNP
Zaporizhia	Zaporizhia	NNP
zeptoampere	zeptoampere	NN
zeptoamperes	zeptoampere	NNS
zeptobecquerel	zeptobecquerel	NN
zeptobecquerels	zeptobecquerel	NNS
zeptocandela	zeptocandela	NN
zeptocandelas	zeptocandela	NNS
zeptocoulomb	zeptocoulomb	NN
zeptocoulombs	zeptocoulomb	NNS
zeptofarad	zeptofarad	NN
zeptofarads	zeptofarad	NNS
zeptogram	zeptogram	NN
zeptogramme	zeptogramme	NN
zeptogrammes	zeptogramme	NNS
zeptograms	zeptogram	NNS
zeptogray	zeptogray	NN
zeptograys	zeptogray	NNS
zeptohenries	zeptohenry	NNS
zeptohenry	zeptohenry	NN
zeptohertz	zeptohertz	NN
zeptohertz	zeptohertz	NNS
zeptojoule	zeptojoule	NN
zeptojoules	zeptojoule	NNS
zeptokatal	zeptokatal	NN
zeptokatals	zeptokatal	NNS
zeptokelvin	zeptokelvin	NN
zeptokelvins	zeptokelvin	NNS
zeptoliter	zeptoliter	NN
zeptoliters	zeptoliter	NNS
zeptolitre	zeptolitre	NN
zeptolitres	zeptolitre	NNS
zeptolumen	zeptolumen	NN
zeptolumens	zeptolumen	NNS
zeptolux	zeptolux	NN
zeptolux	zeptolux	NNS
zeptometer	zeptometer	NN
zeptometers	zeptometer	NNS
zeptometre	zeptometre	NN
zeptometres	zeptometre	NNS
zeptomole	zeptomole	NN
zeptomoles	zeptomole	NNS
zeptonewton	zeptonewton	NN
zeptonewtons	zeptonewton	NNS
zeptoohm	zeptoohm	NN
zeptoohms	zeptoohm	NNS
zeptopascal	zeptopascal	NN
zeptopascals	zeptopascal	NNS
zeptoradian	zeptoradian	NN
zeptoradians	zeptoradian	NNS
zeptosiemens	zeptosiemens	NN
zeptosiemens	zeptosiemens	NNS
zeptosievert	zeptosievert	NN
zeptosieverts	zeptosievert	NNS
zeptosteradian	zeptosteradian	NN
zeptosteradians	zeptosteradian	NNS
zeptotesla	zeptotesla	NN
zeptoteslas	zeptotesla	NNS
zeptovolt	zeptovolt	NN
zeptovolts	zeptovolt	NNS
zeptowatt	zeptowatt	NN
zeptowatts	zeptowatt	NNS
zeptoweber	zeptoweber	NN
zeptowebers	zeptoweber	NNS
zero	zero	NN
zettaampere	zettaampere	NN
zettaamperes	zettaampere	NNS
zettabecquerel	zettabecquerel	NN
zettabecquerels	zettabecquerel	NNS
zettacandela	zettacandela	NN
zettacandelas	zettacandela	NNS
zettacoulomb	zettacoulomb	NN
zettacoulombs	zettacoulomb	NNS
zettafarad	zettafarad	NN
zettafarads	zettafarad	NNS
zettagram	zettagram	NN
zettagramme	zettagramme	NN
zettagrammes	zettagramme	NNS
zettagrams	zettagram	NNS
zettagray	zettagray	NN
zettagrays	zettagray	NNS
zettahenries	zettahenry	NNS
zettahenry	zettahenry	NN
zettahertz	zettahertz	NN
zettahertz	zettahertz	NNS
zettajoule	zettajoule	NN
zettajoules	zettajoule	NNS
zettakatal	zettakatal	NN
zettakatals	zettakatal	NNS
zettakelvin	zettakelvin	NN
zettakelvins	zettakelvin	NNS
zettaliter	zettaliter	NN
zettaliters	zettaliter	NNS
zettalitre	zettalitre	NN
zettalitres	zettalitre	NNS
zettalumen	zettalumen	NN
zettalumens	zettalumen	NNS
zettalux	zettalux	NN
zettalux	zettalux	NNS
zettameter	zettameter	NN
zettameters	zettameter	NNS
zettametre	zettametre	NN
zettametres	zettametre	NNS
zettamole	zettamole	NN
zettamoles	zettamole	NNS
zettanewton	zettanewton	NN
zettanewtons	zettanewton	NNS
zettaohm	zettaohm	NN
zettaohms	zettaohm	NNS
zettapascal	zettapascal	NN
zettapascals	zettapascal	NNS
zettaradian	zettaradian	NN
zettaradians	zettaradian	NNS
zettasiemens	zettasiemens	NN
zettasiemens	zettasiemens	NNS
zettasievert	zettasievert	NN
zettasieverts	zettasievert	NNS
zettasteradian	zettasteradian	NN
zettasteradians	zettasteradian	NNS
zettatesla	zettatesla	NN
zettateslas	zettatesla	NNS
zettavolt	zettavolt	NN
zettavolts	zettavolt	NNS
zettawatt	zettawatt	NN
zettawatts	zettawatt	NNS
zettaweber	zettaweber	NN
zettawebers	zettaweber	NNS
Zhytomyr	Zhytomyr	NNP
