# added postag entries
#-------------------------------------------------------------------------------
# Do not add words here, but report them to languagetool@taaltik.nl
#-------------------------------------------------------------------------------
aandelenfusiefaciliteiten	aandelenfusiefaciliteit	ZNW:MRV:DE_
aandelenfusiefaciliteitje	aandelenfusiefaciliteit	ZNW:EKV:VRK:HET
aandelenfusiefaciliteitjes	aandelenfusiefaciliteit	ZNW:MRV:VRK:DE_
adviesplichtig	adviesplichtig	BNW:STL:ONV
adviesplichtige	adviesplichtig	BNW:STL:VRB
anti-lichaam	anti-lichaam	ZNW:EKV:HET
anti-lichaampje	anti-lichaam	ZNW:EKV:VRK:HET
anti-lichaampjes	anti-lichaam	ZNW:MRV:VRK:DE_
anti-lichamen	anti-lichaam	ZNW:MRV:DE_
baby-artikeltje	baby-artikel	ZNW:EKV:VRK:HET
baby-artikeltjes	baby-artikel	ZNW:MRV:VRK:DE_
bekkenbodemspieroefeningetje	bekkenbodemspieroefening	ZNW:EKV:VRK:HET
bekkenbodemspieroefeningetjes	bekkenbodemspieroefening	ZNW:MRV:VRK:DE_
bereidingstip	bereidingstip	ZNW:EKV:DE_
bereidingstipje	bereidingstip	ZNW:EKV:VRK:HET
bereidingstipjes	bereidingstip	ZNW:MRV:VRK:DE_
bereidingstips	bereidingstip	ZNW:MRV:DE_
beroepsinschakelingstijden	beroepsinschakelingstijd	ZNW:MRV:DE_
beroepsinschakelingstijdje	beroepsinschakelingstijd	ZNW:EKV:VRK:HET
beroepsinschakelingstijdjes	beroepsinschakelingstijd	ZNW:MRV:VRK:DE_
bezwaarlijkheid	bezwaarlijkheid	ZNW:EKV:DE_
bijenlintje	bijenlint	ZNW:EKV:VRK:HET
bijenlintjes	bijenlint	ZNW:MRV:VRK:DE_
broodje	brood	ZNW:EKV:VRK:HET
broodjes	brood	ZNW:MRV:VRK:DE_
brugfiguurtje	brugfiguur	ZNW:EKV:VRK:HET
brugfiguurtjes	brugfiguur	ZNW:MRV:VRK:DE_
btw-behandelingen	btw-behandeling	ZNW:MRV:DE_
btw-behandelingetje	btw-behandeling	ZNW:EKV:VRK:HET
btw-behandelingetjes	btw-behandeling	ZNW:MRV:VRK:DE_
chroomhoudende	chroomhoudend	BNW:STL:VRB
collega-vissertje	collega-visser	ZNW:EKV:VRK:HET
containerzak	containerzak	ZNW:EKV:DE_
containerzakje	containerzak	ZNW:EKV:VRK:HET
containerzakjes	containerzak	ZNW:MRV:VRK:DE_
containerzakken	containerzak	ZNW:MRV:DE_
dameverliesje	dameverlies	ZNW:EKV:VRK:HET
dameverliesjes	dameverlies	ZNW:MRV:VRK:DE_
dameverliezen	dameverlies	ZNW:MRV:DE_
danssoli	danssolo	ZNW:MRV:DE_
danssolootje	danssolo	ZNW:EKV:VRK:HET
danssolootjes	danssolo	ZNW:MRV:VRK:DE_
data-onderzoeken	data-onderzoek	ZNW:MRV:DE_
data-onderzoekje	data-onderzoek	ZNW:EKV:VRK:HET
data-onderzoekjes	data-onderzoek	ZNW:MRV:VRK:DE_
denksnelheden	denksnelheid	ZNW:MRV:DE_
denksnelheidje	denksnelheid	ZNW:EKV:VRK:HET
denksnelheidjes	denksnelheid	ZNW:MRV:VRK:DE_
ego-documentjes	ego-document	ZNW:MRV:VRK:DE_
energiebesparingspotentieeltje	energiebesparingspotentieel	ZNW:EKV:VRK:HET
energiebesparingspotentieeltjes	energiebesparingspotentieel	ZNW:MRV:VRK:DE_
energiebesparingspotentiëlen	energiebesparingspotentieel	ZNW:MRV:DE_
energiebesparingsprogrammaatje	energiebesparingsprogramma	ZNW:EKV:VRK:HET
energiebesparingsprogrammaatjes	energiebesparingsprogramma	ZNW:MRV:VRK:DE_
factuureis	factuureis	ZNW:EKV:DE_
factuureisen	factuureis	ZNW:MRV:DE_
factuureisje	factuureis	ZNW:EKV:VRK:HET
factuureisjes	factuureis	ZNW:MRV:VRK:DE_
familie-leden	familie-lid	ZNW:MRV:DE_
familie-lid	familie-lid	ZNW:EKV:HET
familie-lidje	familie-lid	ZNW:EKV:VRK:HET
familie-lidjes	familie-lid	ZNW:MRV:VRK:DE_
flamencowerelden	flamencowereld	ZNW:MRV:DE_
flamencowereldje	flamencowereld	ZNW:EKV:VRK:HET
flamencowereldjes	flamencowereld	ZNW:MRV:VRK:DE_
fractievoorzittersoverleggen	fractievoorzittersoverleg	ZNW:MRV:DE_
fractievoorzittersoverlegje	fractievoorzittersoverleg	ZNW:EKV:VRK:HET
fractievoorzittersoverlegjes	fractievoorzittersoverleg	ZNW:MRV:VRK:DE_
ganzenakkoordje	ganzenakkoord	ZNW:EKV:VRK:HET
ganzenakkoordjes	ganzenakkoord	ZNW:MRV:VRK:DE_
gasventiel	gasventiel	ZNW:EKV:HET
gasventielen	gasventiel	ZNW:MRV:DE_
gasventieltje	gasventiel	ZNW:EKV:VRK:HET
gasventieltjes	gasventiel	ZNW:MRV:VRK:DE_
geraffineerdheid	geraffineerdheid	ZNW:EKV:DE_
geurverspreidingen	geurverspreiding	ZNW:MRV:DE_
gezichtverzorgingsproducten	gezichtsverzorgingsproduct	ZNW:MRV:DE_
gezichtverzorgingsproductje	gezichtsverzorgingsproduct	ZNW:EKV:VRK:HET
gezichtverzorgingsproductjes	gezichtsverzorgingsproduct	ZNW:MRV:VRK:DE_
graafklauwen	graafklauw	ZNW:MRV:DE_
graafklauwtje	graafklauw	ZNW:EKV:VRK:HET
graafklauwtjes	graafklauw	ZNW:MRV:VRK:DE_
graskwaliteitje	graskwaliteit	ZNW:EKV:VRK:HET
graskwaliteitjes	graskwaliteit	ZNW:MRV:VRK:DE_
hobby-artikels	hobby-artikel	ZNW:MRV:DE_
hobby-artikeltje	hobby-artikel	ZNW:EKV:VRK:HET
hobby-artikeltjes	hobby-artikel	ZNW:MRV:VRK:DE_
hormoonfactortje	hormoonfactor	ZNW:EKV:VRK:HET
hormoonfactortjes	hormoonfactor	ZNW:MRV:VRK:DE_
huidgeleidingen	huidgeleiding	ZNW:MRV:DE_
huidgeleidingetjes	huidgeleiding	ZNW:MRV:VRK:DE_
huidstofwisselingen	huidstofwisseling	ZNW:MRV:DE_
huidstofwisselinkje	huidstofwisseling	ZNW:EKV:VRK:HET
huidstofwisselinkjes	huidstofwisseling	ZNW:MRV:VRK:DE_
huisplattegronden	huisplattegrond	ZNW:MRV:DE_
huisplattegrondje	huisplattegrond	ZNW:EKV:VRK:HET
huisplattegrondjes	huisplattegrond	ZNW:MRV:VRK:DE_
hulpvoertuig	hulpvoertuig	ZNW:EKV:HET
hulpvoertuigen	hulpvoertuig	ZNW:MRV:DE_
hulpvoertuigje	hulpvoertuig	ZNW:EKV:VRK:HET
hulpvoertuigjes	hulpvoertuig	ZNW:MRV:VRK:DE_
inkoopsprijsje	inkoopsprijs	ZNW:EKV:VRK:HET
inkoopsprijsjes	inkoopsprijs	ZNW:MRV:VRK:DE_
jaaruitgaven	jaaruitgave	ZNW:MRV:DE_
kaasspecialistje	kaasspecialist	ZNW:EKV:VRK:HET
kaasspecialistjes	kaasspecialist	ZNW:MRV:VRK:DE_
keepersoutfitje	keepersoutfit	ZNW:EKV:VRK:HET
keepersoutfitjes	keepersoutfit	ZNW:MRV:VRK:DE_
keepersoutfits	keepersoutfit	ZNW:MRV:DE_
klantreis	klantreis	ZNW:EKV:DE_
klantreisje	klantreis	ZNW:EKV:VRK:HET
klantreisjes	klantreis	ZNW:MRV:VRK:DE_
klantreizen	klantreis	ZNW:MRV:DE_
klimverenigingetje	klimvereniging	ZNW:EKV:VRK:HET
klimverenigingetjes	klimvereniging	ZNW:MRV:VRK:DE_
klimvereniginkje	klimvereniging	ZNW:EKV:VRK:HET
klimvereniginkjes	klimvereniging	ZNW:MRV:VRK:DE_
kokossnippers	kokossnipper	ZNW:MRV:DE_
kokossnippertje	kokossnipper	ZNW:EKV:VRK:HET
kokossnippertjes	kokossnipper	ZNW:MRV:VRK:DE_
krulmotief	krulmotief	ZNW:EKV:HET
krulmotiefje	krulmotief	ZNW:EKV:VRK:HET
krulmotiefjes	krulmotief	ZNW:MRV:VRK:DE_
krulmotieven	krulmotief	ZNW:MRV:DE_
lachkriebels	lachkriebel	ZNW:MRV:DE_
lachkriebeltje	lachkriebel	ZNW:EKV:VRK:HET
lachkriebeltjes	lachkriebel	ZNW:MRV:VRK:DE_
levensbestendig	levensbestendig	BNW:STL:ONV
levensbestendige	levensbestendig	BNW:STL:VRB
liquidatieverliesregelingen	liquidatieverliesregeling	ZNW:MRV:DE_
liquidatieverliesregelingetje	liquidatieverliesregeling	ZNW:EKV:VRK:HET
liquidatieverliesregelingetjes	liquidatieverliesregeling	ZNW:MRV:VRK:DE_
lotcodes	lotcode	ZNW:MRV:DE_
lotcodetje	lotcode	ZNW:EKV:VRK:HET
lotcodetjes	lotcode	ZNW:MRV:VRK:DE_
luistertaak	luistertaak	ZNW:EKV:DE_
luistertaakje	luistertaak	ZNW:EKV:VRK:HET
luistertaakjes	luistertaak	ZNW:MRV:VRK:DE_
luistertaken	luistertaak	ZNW:MRV:DE_
maart-edities	maart-editie	ZNW:MRV:DE_
massa-producties	massa-productie	ZNW:MRV:DE_
massa-productietje	massa-productie	ZNW:EKV:VRK:HET
massa-productietjes	massa-productie	ZNW:MRV:VRK:DE_
maststrijkinstallatietje	maststrijkinstallatie	ZNW:EKV:VRK:HET
maststrijkinstallatietjes	maststrijkinstallatie	ZNW:MRV:VRK:DE_
maïsbladen	maïsblad	ZNW:MRV:DE_
maïsbladeren	maïsblad	ZNW:MRV:DE_
medezeggenschapswerken	medezeggenschapswerk	ZNW:MRV:DE_
medezeggenschapswerkje	medezeggenschapswerk	ZNW:EKV:VRK:HET
medezeggenschapswerkjes	medezeggenschapswerk	ZNW:MRV:VRK:DE_
media-onderzoeken	media-onderzoek	ZNW:MRV:DE_
media-onderzoekje	media-onderzoek	ZNW:EKV:VRK:HET
media-onderzoekjes	media-onderzoek	ZNW:MRV:VRK:DE_
meditatiekamers	meditatiekamer	ZNW:MRV:DE_
meditatiekamertjes	meditatiekamer	ZNW:MRV:VRK:DE_
meetpaaltje	meetpaal	ZNW:EKV:VRK:HET
mierenbroden	mierenbrood	ZNW:MRV:DE_
mierenbroodje	mierenbrood	ZNW:EKV:VRK:HET
mierenbroodjes	mierenbrood	ZNW:MRV:VRK:DE_
mini-formaatje	mini-formaat	ZNW:EKV:VRK:HET
mini-formaatjes	mini-formaat	ZNW:MRV:VRK:DE_
mini-formaten	mini-formaat	ZNW:MRV:DE_
mini-uitvoerinkje	mini-uitvoering	ZNW:EKV:VRK:HET
mini-uitvoerinkjes	mini-uitvoering	ZNW:MRV:VRK:DE_
mosselbed	mosselbed	ZNW:EKV:HET
mosselbedden	mosselbed	ZNW:MRV:DE_
mosselbedje	mosselbed	ZNW:EKV:VRK:HET
mosselbedjes	mosselbed	ZNW:MRV:VRK:DE_
nieuws-itempjes	nieuws-item	ZNW:MRV:VRK:DE_
nooddocumentjes	nooddocument	ZNW:MRV:VRK:DE_
omroepfunctietje	omroepfunctie	ZNW:EKV:VRK:HET
omroepfunctietjes	omroepfunctie	ZNW:MRV:VRK:DE_
onderwijseis	onderwijseis	ZNW:EKV:DE_
onderwijseisen	onderwijseis	ZNW:MRV:DE_
onderwijseisje	onderwijseis	ZNW:EKV:VRK:HET
onderwijseisjes	onderwijseis	ZNW:MRV:VRK:DE_
ongevalsschaden	ongevalsschade	ZNW:MRV:DE_
ongevalsschades	ongevalsschade	ZNW:MRV:DE_
ongevalsschadetje	ongevalsschade	ZNW:EKV:VRK:HET
ongevalsschadetjes	ongevalsschade	ZNW:MRV:VRK:DE_
pdf-formuliertje	pdf-formulier	ZNW:EKV:VRK:HET
pdf-formuliertjes	pdf-formulier	ZNW:MRV:VRK:DE_
placebo-groepen	placebo-groep	ZNW:MRV:DE_
placebo-groepjes	placebo-groep	ZNW:MRV:VRK:DE_
plateaufases	plateaufase	ZNW:MRV:DE_
post-modernismen	post-modernisme	ZNW:MRV:DE_
praktijk-examentjes	praktijk-examen	ZNW:MRV:VRK:DE_
praktijkpilotje	praktijkpilot	ZNW:EKV:VRK:HET
praktijkpilotjes	praktijkpilot	ZNW:MRV:VRK:DE_
privé-auto's	privé-auto	ZNW:MRV:DE_
privé-autootje	privé-auto	ZNW:EKV:VRK:HET
privé-autootjes	privé-auto	ZNW:MRV:VRK:DE_
privé-berichten	privé-bericht	ZNW:MRV:DE_
privé-berichtje	privé-bericht	ZNW:EKV:VRK:HET
privé-berichtjes	privé-bericht	ZNW:MRV:VRK:DE_
privé-foto's	privé-foto	ZNW:MRV:DE_
privé-fotootje	privé-foto	ZNW:EKV:VRK:HET
privé-fotootjes	privé-foto	ZNW:MRV:VRK:DE_
privé-karakters	privé-karakter	ZNW:MRV:DE_
privé-karaktertje	privé-karakter	ZNW:EKV:VRK:HET
privé-karaktertjes	privé-karakter	ZNW:MRV:VRK:DE_
produceerbaarheid	produceerbaarheid	ZNW:EKV:DE_
protestpetitietje	protestpetitie	ZNW:EKV:VRK:HET
reflexrestant	reflexrestant	ZNW:EKV:DE_
reinigingsolies	reinigingsolie	ZNW:MRV:DE_
reinigingsolietje	reinigingsolie	ZNW:EKV:VRK:HET
reinigingsolietjes	reinigingsolie	ZNW:MRV:VRK:DE_
reinigingsoliën	reinigingsolie	ZNW:MRV:DE_
rente-opslagje	rente-opslag	ZNW:EKV:VRK:HET
rente-opslagjes	rente-opslag	ZNW:MRV:VRK:DE_
risico-factoren	risico-factor	ZNW:MRV:DE_
risico-factortje	risico-factor	ZNW:EKV:VRK:HET
risico-factortjes	risico-factor	ZNW:MRV:VRK:DE_
schadetaxatietje	schadetaxatie	ZNW:EKV:VRK:HET
schadetaxatietjes	schadetaxatie	ZNW:MRV:VRK:DE_
ski-ongevalletje	ski-ongeval	ZNW:EKV:VRK:HET
ski-ongevalletjes	ski-ongeval	ZNW:MRV:VRK:DE_
ski-oordje	ski-oord	ZNW:EKV:VRK:HET
ski-oordjes	ski-oord	ZNW:MRV:VRK:DE_
slotvoorstellinkje	slotvoorstelling	ZNW:EKV:VRK:HET
slotvoorstellinkjes	slotvoorstelling	ZNW:MRV:VRK:DE_
solo-tentoonstellinkje	solo-tentoonstelling	ZNW:EKV:VRK:HET
solo-tentoonstellinkjes	solo-tentoonstelling	ZNW:MRV:VRK:DE_
surfdude	surfdude	ZNW:EKV:DE_
tariefbladen	tariefblad	ZNW:MRV:DE_
tariefbladeren	tariefblad	ZNW:MRV:DE_
telefoonbomen	telefoonboom	ZNW:MRV:DE_
telefoonboompje	telefoonboom	ZNW:EKV:VRK:HET
testcoördinatortje	testcoördinator	ZNW:EKV:VRK:HET
testcoördinatortjes	testcoördinator	ZNW:MRV:VRK:DE_
thuisbatterijtje	thuisbatterij	ZNW:EKV:VRK:HET
thuisbatterijtjes	thuisbatterij	ZNW:MRV:VRK:DE_
trajectcontrolesysteempje	trajectcontrolesysteem	ZNW:EKV:VRK:HET
trajectcontrolesysteempjes	trajectcontrolesysteem	ZNW:MRV:VRK:DE_
tramreizigertje	tramreiziger	ZNW:EKV:VRK:HET
tramreizigertjes	tramreiziger	ZNW:MRV:VRK:DE_
tuinbouwtentoonstellinkje	tuinbouwtentoonstelling	ZNW:EKV:VRK:HET
tuinbouwtentoonstellinkjes	tuinbouwtentoonstelling	ZNW:MRV:VRK:DE_
tv-inkomsten	tv-inkomsten	ZNW:MRV:DE_
verfspuitbus	verfspuitbus	ZNW:EKV:DE_
verfspuitbusje	verfspuitbus	ZNW:EKV:VRK:HET
verfspuitbusjes	verfspuitbus	ZNW:MRV:VRK:DE_
verfspuitbussen	verfspuitbus	ZNW:MRV:DE_
verkeersveiligheidsmaatregels	verkeersveiligheidsmaatregel	ZNW:MRV:DE_
verkeersveiligheidsmaatregeltje	verkeersveiligheidsmaatregel	ZNW:EKV:VRK:HET
verkeersveiligheidsmaatregeltjes	verkeersveiligheidsmaatregel	ZNW:MRV:VRK:DE_
verzamelpanden	verzamelpand	ZNW:MRV:DE_
verzamelpandje	verzamelpand	ZNW:EKV:VRK:HET
verzamelpandjes	verzamelpand	ZNW:MRV:VRK:DE_
vingervlekje	vingervlek	ZNW:EKV:VRK:HET
vingervlekjes	vingervlek	ZNW:MRV:VRK:DE_
vingervlekken	vingervlek	ZNW:MRV:DE_
voedingsmiddelenfabrikantje	voedingsmiddelenfabrikant	ZNW:EKV:VRK:HET
voedingsmiddelenfabrikantjes	voedingsmiddelenfabrikant	ZNW:MRV:VRK:DE_
voedselconsumptiepeilinkje	voedselconsumptiepeiling	ZNW:EKV:VRK:HET
voedselconsumptiepeilinkjes	voedselconsumptiepeiling	ZNW:MRV:VRK:DE_
voedselveiligheidssysteempje	voedselveiligheidssysteem	ZNW:EKV:VRK:HET
voedselveiligheidssysteempjes	voedselveiligheidssysteem	ZNW:MRV:VRK:DE_
volkshuisvestingsbelangen	volkshuisvestingsbelang	ZNW:MRV:DE_
volkshuisvestingsbelangetje	volkshuisvestingsbelang	ZNW:EKV:VRK:HET
volkshuisvestingsbelangetjes	volkshuisvestingsbelang	ZNW:MRV:VRK:DE_
wat-vraagje	wat-vraag	ZNW:EKV:VRK:HET
wat-vraagjes	wat-vraag	ZNW:MRV:VRK:DE_
wat-vragen	wat-vraag	ZNW:MRV:DE_
welzijnstaak	welzijnstaak	ZNW:EKV:DE_
welzijnstaakje	welzijnstaak	ZNW:EKV:VRK:HET
welzijnstaakjes	welzijnstaak	ZNW:MRV:VRK:DE_
welzijnstaken	welzijnstaak	ZNW:MRV:DE_
werkgeverstaak	werkgeverstaak	ZNW:EKV:DE_
werkgeverstaakje	werkgeverstaak	ZNW:EKV:VRK:HET
werkgeverstaakjes	werkgeverstaak	ZNW:MRV:VRK:DE_
werkgeverstaken	werkgeverstaak	ZNW:MRV:DE_
wijnopslagen	wijnopslag	ZNW:MRV:DE_
wijnopslagje	wijnopslag	ZNW:EKV:VRK:HET
wijnopslagjes	wijnopslag	ZNW:MRV:VRK:DE_
windvoorspellinkje	windvoorspelling	ZNW:EKV:VRK:HET
windvoorspellinkjes	windvoorspelling	ZNW:MRV:VRK:DE_
wortelstekje	wortelstek	ZNW:EKV:VRK:HET
wortelstekken	wortelstek	ZNW:MRV:DE_
zorgvergoedinkje	zorgvergoeding	ZNW:EKV:VRK:HET
zorgvergoedinkjes	zorgvergoeding	ZNW:MRV:VRK:DE_
