# deleted postag entries
#-------------------------------------------------------------------------------
# Do not add words here, but report them to languagetool@taaltik.nl
#-------------------------------------------------------------------------------
EU-regeringsleidertje	EU-regeringsleider	ZNW:EKV:VRK:HET
EU-regeringsleidertjes	EU-regeringsleider	ZNW:MRV:VRK:DE_
aardeverbindingetje	aardeverbinding	ZNW:EKV:VRK:HET
aardeverbindingetjes	aardeverbinding	ZNW:MRV:VRK:DE_
aardverbindingetje	aardverbinding	ZNW:EKV:VRK:HET
aardverbindingetjes	aardverbinding	ZNW:MRV:VRK:DE_
achterlandverbindingetje	achterlandverbinding	ZNW:EKV:VRK:HET
achterlandverbindingetjes	achterlandverbinding	ZNW:MRV:VRK:DE_
afstandsverbindingetje	afstandsverbinding	ZNW:EKV:VRK:HET
afstandsverbindingetjes	afstandsverbinding	ZNW:MRV:VRK:DE_
afvoerverbindingetje	afvoerverbinding	ZNW:EKV:VRK:HET
afvoerverbindingetjes	afvoerverbinding	ZNW:MRV:VRK:DE_
afwateringsverbindingetje	afwateringsverbinding	ZNW:EKV:VRK:HET
afwateringsverbindingetjes	afwateringsverbinding	ZNW:MRV:VRK:DE_
akkoordverbindingetje	akkoordverbinding	ZNW:EKV:VRK:HET
akkoordverbindingetjes	akkoordverbinding	ZNW:MRV:VRK:DE_
alcoholverbindingetje	alcoholverbinding	ZNW:EKV:VRK:HET
alcoholverbindingetjes	alcoholverbinding	ZNW:MRV:VRK:DE_
aluminiumverbindingetje	aluminiumverbinding	ZNW:EKV:VRK:HET
aluminiumverbindingetjes	aluminiumverbinding	ZNW:MRV:VRK:DE_
ammoniumverbindingetje	ammoniumverbinding	ZNW:EKV:VRK:HET
ammoniumverbindingetjes	ammoniumverbinding	ZNW:MRV:VRK:DE_
ankerverbindingetje	ankerverbinding	ZNW:EKV:VRK:HET
ankerverbindingetjes	ankerverbinding	ZNW:MRV:VRK:DE_
antenneverbindingetje	antenneverbinding	ZNW:EKV:VRK:HET
antenneverbindingetjes	antenneverbinding	ZNW:MRV:VRK:DE_
arseenverbindingetje	arseenverbinding	ZNW:EKV:VRK:HET
arseenverbindingetjes	arseenverbinding	ZNW:MRV:VRK:DE_
audioverbindingetje	audioverbinding	ZNW:EKV:VRK:HET
audioverbindingetjes	audioverbinding	ZNW:MRV:VRK:DE_
autobusverbindingetje	autobusverbinding	ZNW:EKV:VRK:HET
autobusverbindingetjes	autobusverbinding	ZNW:MRV:VRK:DE_
autosnelwegverbindingetje	autosnelwegverbinding	ZNW:EKV:VRK:HET
autosnelwegverbindingetjes	autosnelwegverbinding	ZNW:MRV:VRK:DE_
autoverbindingetje	autoverbinding	ZNW:EKV:VRK:HET
autoverbindingetjes	autoverbinding	ZNW:MRV:VRK:DE_
autowegverbindingetje	autowegverbinding	ZNW:EKV:VRK:HET
autowegverbindingetjes	autowegverbinding	ZNW:MRV:VRK:DE_
baby-uitzet	baby-uitzet	ZNW:EKV
bajonetverbindingetje	bajonetverbinding	ZNW:EKV:VRK:HET
bajonetverbindingetjes	bajonetverbinding	ZNW:MRV:VRK:DE_
bandbreedteverbindingetje	bandbreedteverbinding	ZNW:EKV:VRK:HET
bandbreedteverbindingetjes	bandbreedteverbinding	ZNW:MRV:VRK:DE_
bankverbindingetje	bankverbinding	ZNW:EKV:VRK:HET
bankverbindingetjes	bankverbinding	ZNW:MRV:VRK:DE_
basisverbindingetje	basisverbinding	ZNW:EKV:VRK:HET
basisverbindingetjes	basisverbinding	ZNW:MRV:VRK:DE_
bedrijfsverbindingetje	bedrijfsverbinding	ZNW:EKV:VRK:HET
bedrijfsverbindingetjes	bedrijfsverbinding	ZNW:MRV:VRK:DE_
beeldschermverbindingetje	beeldschermverbinding	ZNW:EKV:VRK:HET
beeldschermverbindingetjes	beeldschermverbinding	ZNW:MRV:VRK:DE_
beeldspraakverbindingetje	beeldspraakverbinding	ZNW:EKV:VRK:HET
beeldspraakverbindingetjes	beeldspraakverbinding	ZNW:MRV:VRK:DE_
beeldverbindingetje	beeldverbinding	ZNW:EKV:VRK:HET
beeldverbindingetjes	beeldverbinding	ZNW:MRV:VRK:DE_
benzine-auto	benzine-auto	ZNW:EKV
betalingsverbindingetje	betalingsverbinding	ZNW:EKV:VRK:HET
betalingsverbindingetjes	betalingsverbinding	ZNW:MRV:VRK:DE_
beugelverbindingetje	beugelverbinding	ZNW:EKV:VRK:HET
beugelverbindingetjes	beugelverbinding	ZNW:MRV:VRK:DE_
bewegingsverbindingetje	bewegingsverbinding	ZNW:EKV:VRK:HET
bewegingsverbindingetjes	bewegingsverbinding	ZNW:MRV:VRK:DE_
bindweefselverbindingetje	bindweefselverbinding	ZNW:EKV:VRK:HET
bindweefselverbindingetjes	bindweefselverbinding	ZNW:MRV:VRK:DE_
binnenscheepvaartverbindingetje	binnenscheepvaartverbinding	ZNW:EKV:VRK:HET
binnenscheepvaartverbindingetjes	binnenscheepvaartverbinding	ZNW:MRV:VRK:DE_
binnenvaartverbindingetje	binnenvaartverbinding	ZNW:EKV:VRK:HET
binnenvaartverbindingetjes	binnenvaartverbinding	ZNW:MRV:VRK:DE_
binnenverbindingetje	binnenverbinding	ZNW:EKV:VRK:HET
binnenverbindingetjes	binnenverbinding	ZNW:MRV:VRK:DE_
bloedverbindingetje	bloedverbinding	ZNW:EKV:VRK:HET
bloedverbindingetjes	bloedverbinding	ZNW:MRV:VRK:DE_
bodemverstorende	bodemverstorende	BNW:STL:VRB
boemelverbindingetje	boemelverbinding	ZNW:EKV:VRK:HET
boemelverbindingetjes	boemelverbinding	ZNW:MRV:VRK:DE_
bootverbindingetje	bootverbinding	ZNW:EKV:VRK:HET
bootverbindingetjes	bootverbinding	ZNW:MRV:VRK:DE_
borstverbindingetje	borstverbinding	ZNW:EKV:VRK:HET
borstverbindingetjes	borstverbinding	ZNW:MRV:VRK:DE_
bosverbindingetje	bosverbinding	ZNW:EKV:VRK:HET
bosverbindingetjes	bosverbinding	ZNW:MRV:VRK:DE_
boutverbindingetje	boutverbinding	ZNW:EKV:VRK:HET
boutverbindingetjes	boutverbinding	ZNW:MRV:VRK:DE_
breedbandverbindingetje	breedbandverbinding	ZNW:EKV:VRK:HET
breedbandverbindingetjes	breedbandverbinding	ZNW:MRV:VRK:DE_
broomverbindingetje	broomverbinding	ZNW:EKV:VRK:HET
broomverbindingetjes	broomverbinding	ZNW:MRV:VRK:DE_
brugverbindingetje	brugverbinding	ZNW:EKV:VRK:HET
brugverbindingetjes	brugverbinding	ZNW:MRV:VRK:DE_
buisverbindingetje	buisverbinding	ZNW:EKV:VRK:HET
buisverbindingetjes	buisverbinding	ZNW:MRV:VRK:DE_
buitenlandverbindingetje	buitenlandverbinding	ZNW:EKV:VRK:HET
buitenlandverbindingetjes	buitenlandverbinding	ZNW:MRV:VRK:DE_
bureaubladverbindingetje	bureaubladverbinding	ZNW:EKV:VRK:HET
bureaubladverbindingetjes	bureaubladverbinding	ZNW:MRV:VRK:DE_
busverbindingetje	busverbinding	ZNW:EKV:VRK:HET
busverbindingetjes	busverbinding	ZNW:MRV:VRK:DE_
buurtbusverbindingetje	buurtbusverbinding	ZNW:EKV:VRK:HET
buurtbusverbindingetjes	buurtbusverbinding	ZNW:MRV:VRK:DE_
cameraverbindingetje	cameraverbinding	ZNW:EKV:VRK:HET
cameraverbindingetjes	cameraverbinding	ZNW:MRV:VRK:DE_
catamaranverbindingetje	catamaranverbinding	ZNW:EKV:VRK:HET
catamaranverbindingetjes	catamaranverbinding	ZNW:MRV:VRK:DE_
centrumverbindingetje	centrumverbinding	ZNW:EKV:VRK:HET
centrumverbindingetjes	centrumverbinding	ZNW:MRV:VRK:DE_
chloorfluorkoolstofverbindingetjes	chloorfluorkoolstofverbinding	ZNW:MRV:VRK:DE_
chloorverbindingetje	chloorverbinding	ZNW:EKV:VRK:HET
chloorverbindingetjes	chloorverbinding	ZNW:MRV:VRK:DE_
chroomverbindingetje	chroomverbinding	ZNW:EKV:VRK:HET
chroomverbindingetjes	chroomverbinding	ZNW:MRV:VRK:DE_
clickverbindingetje	clickverbinding	ZNW:EKV:VRK:HET
clickverbindingetjes	clickverbinding	ZNW:MRV:VRK:DE_
communicatieverbindingetje	communicatieverbinding	ZNW:EKV:VRK:HET
communicatieverbindingetjes	communicatieverbinding	ZNW:MRV:VRK:DE_
computerverbindingetje	computerverbinding	ZNW:EKV:VRK:HET
computerverbindingetjes	computerverbinding	ZNW:MRV:VRK:DE_
contactverbindingetje	contactverbinding	ZNW:EKV:VRK:HET
contactverbindingetjes	contactverbinding	ZNW:MRV:VRK:DE_
databaseverbindingetje	databaseverbinding	ZNW:EKV:VRK:HET
databaseverbindingetjes	databaseverbinding	ZNW:MRV:VRK:DE_
dataverbindingetje	dataverbinding	ZNW:EKV:VRK:HET
dataverbindingetjes	dataverbinding	ZNW:MRV:VRK:DE_
desktopverbindingetje	desktopverbinding	ZNW:EKV:VRK:HET
desktopverbindingetjes	desktopverbinding	ZNW:MRV:VRK:DE_
doorloopverbindingetje	doorloopverbinding	ZNW:EKV:VRK:HET
doorloopverbindingetjes	doorloopverbinding	ZNW:MRV:VRK:DE_
doorverbindingetje	doorverbinding	ZNW:EKV:VRK:HET
doorverbindingetjes	doorverbinding	ZNW:MRV:VRK:DE_
downloadverbindingetje	downloadverbinding	ZNW:EKV:VRK:HET
downloadverbindingetjes	downloadverbinding	ZNW:MRV:VRK:DE_
draadverbindingetje	draadverbinding	ZNW:EKV:VRK:HET
draadverbindingetjes	draadverbinding	ZNW:MRV:VRK:DE_
driehoeksverbindingetje	driehoeksverbinding	ZNW:EKV:VRK:HET
driehoeksverbindingetjes	driehoeksverbinding	ZNW:MRV:VRK:DE_
droomverbindingetje	droomverbinding	ZNW:EKV:VRK:HET
droomverbindingetjes	droomverbinding	ZNW:MRV:VRK:DE_
druggerelateerde	druggerelateerde	BNW:STL:VRB
dwarsverbindingetje	dwarsverbinding	ZNW:EKV:VRK:HET
dwarsverbindingetjes	dwarsverbinding	ZNW:MRV:VRK:DE_
eenrichtingsverbindingetje	eenrichtingsverbinding	ZNW:EKV:VRK:HET
eenrichtingsverbindingetjes	eenrichtingsverbinding	ZNW:MRV:VRK:DE_
eindverbindingetje	eindverbinding	ZNW:EKV:VRK:HET
eindverbindingetjes	eindverbinding	ZNW:MRV:VRK:DE_
eiwitverbindingetje	eiwitverbinding	ZNW:EKV:VRK:HET
eiwitverbindingetjes	eiwitverbinding	ZNW:MRV:VRK:DE_
elektriciteitstransportverbindingetje	elektriciteitstransportverbinding	ZNW:EKV:VRK:HET
elektriciteitstransportverbindingetjes	elektriciteitstransportverbinding	ZNW:MRV:VRK:DE_
elektroverbindingetje	elektroverbinding	ZNW:EKV:VRK:HET
elektroverbindingetjes	elektroverbinding	ZNW:MRV:VRK:DE_
elementverbindingetje	elementverbinding	ZNW:EKV:VRK:HET
elementverbindingetjes	elementverbinding	ZNW:MRV:VRK:DE_
emissie-arme	emissie-arme	UNSPECIFIED
energieverbindingetje	energieverbinding	ZNW:EKV:VRK:HET
energieverbindingetjes	energieverbinding	ZNW:MRV:VRK:DE_
ethernetverbindingetje	ethernetverbinding	ZNW:EKV:VRK:HET
ethernetverbindingetjes	ethernetverbinding	ZNW:MRV:VRK:DE_
etherverbindingetje	etherverbinding	ZNW:EKV:VRK:HET
etherverbindingetjes	etherverbinding	ZNW:MRV:VRK:DE_
faxverbindingetje	faxverbinding	ZNW:EKV:VRK:HET
faxverbindingetjes	faxverbinding	ZNW:MRV:VRK:DE_
fenolverbindingetje	fenolverbinding	ZNW:EKV:VRK:HET
fenolverbindingetjes	fenolverbinding	ZNW:MRV:VRK:DE_
fietsverbindingetje	fietsverbinding	ZNW:EKV:VRK:HET
fietsverbindingetjes	fietsverbinding	ZNW:MRV:VRK:DE_
flensverbindingetje	flensverbinding	ZNW:EKV:VRK:HET
flensverbindingetjes	flensverbinding	ZNW:MRV:VRK:DE_
flitstreinverbindingetje	flitstreinverbinding	ZNW:EKV:VRK:HET
flitstreinverbindingetjes	flitstreinverbinding	ZNW:MRV:VRK:DE_
flitten	flitten	UNSPECIFIED
fluorverbindingetje	fluorverbinding	ZNW:EKV:VRK:HET
fluorverbindingetjes	fluorverbinding	ZNW:MRV:VRK:DE_
fosfaatverbindingetje	fosfaatverbinding	ZNW:EKV:VRK:HET
fosfaatverbindingetjes	fosfaatverbinding	ZNW:MRV:VRK:DE_
fosforverbindingetje	fosforverbinding	ZNW:EKV:VRK:HET
fosforverbindingetjes	fosforverbinding	ZNW:MRV:VRK:DE_
fotospul	fotospul	ZNW:EKV:DE_
gegevensverbindingetje	gegevensverbinding	ZNW:EKV:VRK:HET
gegevensverbindingetjes	gegevensverbinding	ZNW:MRV:VRK:DE_
geleidingsverbindingetje	geleidingsverbinding	ZNW:EKV:VRK:HET
geleidingsverbindingetjes	geleidingsverbinding	ZNW:MRV:VRK:DE_
gelijkstroomverbindingetje	gelijkstroomverbinding	ZNW:EKV:VRK:HET
gelijkstroomverbindingetjes	gelijkstroomverbinding	ZNW:MRV:VRK:DE_
geluidsverbindingetje	geluidsverbinding	ZNW:EKV:VRK:HET
geluidsverbindingetjes	geluidsverbinding	ZNW:MRV:VRK:DE_
geluidverbindingetje	geluidverbinding	ZNW:EKV:VRK:HET
geluidverbindingetjes	geluidverbinding	ZNW:MRV:VRK:DE_
gevoelsverbindingetje	gevoelsverbinding	ZNW:EKV:VRK:HET
gevoelsverbindingetjes	gevoelsverbinding	ZNW:MRV:VRK:DE_
gewrichtsverbindingetje	gewrichtsverbinding	ZNW:EKV:VRK:HET
gewrichtsverbindingetjes	gewrichtsverbinding	ZNW:MRV:VRK:DE_
glasverbindingetje	glasverbinding	ZNW:EKV:VRK:HET
glasverbindingetjes	glasverbinding	ZNW:MRV:VRK:DE_
glasvezelinternetverbindingetje	glasvezelinternetverbinding	ZNW:EKV:VRK:HET
glasvezelinternetverbindingetjes	glasvezelinternetverbinding	ZNW:MRV:VRK:DE_
glasvezelkabelverbindingetje	glasvezelkabelverbinding	ZNW:EKV:VRK:HET
glasvezelkabelverbindingetjes	glasvezelkabelverbinding	ZNW:MRV:VRK:DE_
glasvezelverbindingetje	glasvezelverbinding	ZNW:EKV:VRK:HET
glasvezelverbindingetjes	glasvezelverbinding	ZNW:MRV:VRK:DE_
goederenverbindingetje	goederenverbinding	ZNW:EKV:VRK:HET
goederenverbindingetjes	goederenverbinding	ZNW:MRV:VRK:DE_
gondelverbindingetje	gondelverbinding	ZNW:EKV:VRK:HET
gondelverbindingetjes	gondelverbinding	ZNW:MRV:VRK:DE_
grensverbindingetje	grensverbinding	ZNW:EKV:VRK:HET
grensverbindingetjes	grensverbinding	ZNW:MRV:VRK:DE_
groefverbindingetje	groefverbinding	ZNW:EKV:VRK:HET
groefverbindingetjes	groefverbinding	ZNW:MRV:VRK:DE_
groenverbindingetje	groenverbinding	ZNW:EKV:VRK:HET
groenverbindingetjes	groenverbinding	ZNW:MRV:VRK:DE_
groepsverbindingetje	groepsverbinding	ZNW:EKV:VRK:HET
groepsverbindingetjes	groepsverbinding	ZNW:MRV:VRK:DE_
grondverbindingetje	grondverbinding	ZNW:EKV:VRK:HET
grondverbindingetjes	grondverbinding	ZNW:MRV:VRK:DE_
halogeenverbindingetje	halogeenverbinding	ZNW:EKV:VRK:HET
halogeenverbindingetjes	halogeenverbinding	ZNW:MRV:VRK:DE_
handelsverbindingetje	handelsverbinding	ZNW:EKV:VRK:HET
handelsverbindingetjes	handelsverbinding	ZNW:MRV:VRK:DE_
hartverbindingetje	hartverbinding	ZNW:EKV:VRK:HET
hartverbindingetjes	hartverbinding	ZNW:MRV:VRK:DE_
havenverbindingetje	havenverbinding	ZNW:EKV:VRK:HET
havenverbindingetjes	havenverbinding	ZNW:MRV:VRK:DE_
helikopterverbindingetje	helikopterverbinding	ZNW:EKV:VRK:HET
helikopterverbindingetjes	helikopterverbinding	ZNW:MRV:VRK:DE_
hersenverbindingetje	hersenverbinding	ZNW:EKV:VRK:HET
hersenverbindingetjes	hersenverbinding	ZNW:MRV:VRK:DE_
hittewerende	hittewerende	BNW:STL:VRB
hoekverbindingetje	hoekverbinding	ZNW:EKV:VRK:HET
hoekverbindingetjes	hoekverbinding	ZNW:MRV:VRK:DE_
hogesnelheidsinternetverbindingetje	hogesnelheidsinternetverbinding	ZNW:EKV:VRK:HET
hogesnelheidsinternetverbindingetjes	hogesnelheidsinternetverbinding	ZNW:MRV:VRK:DE_
hogesnelheidsspoorverbindingetje	hogesnelheidsspoorverbinding	ZNW:EKV:VRK:HET
hogesnelheidsspoorverbindingetjes	hogesnelheidsspoorverbinding	ZNW:MRV:VRK:DE_
hogesnelheidsverbindingetje	hogesnelheidsverbinding	ZNW:EKV:VRK:HET
hogesnelheidsverbindingetjes	hogesnelheidsverbinding	ZNW:MRV:VRK:DE_
hoofdfietsverbindingetje	hoofdfietsverbinding	ZNW:EKV:VRK:HET
hoofdfietsverbindingetjes	hoofdfietsverbinding	ZNW:MRV:VRK:DE_
hoofdverbindingetje	hoofdverbinding	ZNW:EKV:VRK:HET
hoofdverbindingetjes	hoofdverbinding	ZNW:MRV:VRK:DE_
hoogspanningsverbindingetje	hoogspanningsverbinding	ZNW:EKV:VRK:HET
hoogspanningsverbindingetjes	hoogspanningsverbinding	ZNW:MRV:VRK:DE_
houtverbindingetje	houtverbinding	ZNW:EKV:VRK:HET
houtverbindingetjes	houtverbinding	ZNW:MRV:VRK:DE_
huwelijksverbindingetje	huwelijksverbinding	ZNW:EKV:VRK:HET
huwelijksverbindingetjes	huwelijksverbinding	ZNW:MRV:VRK:DE_
ijzerverbindingetje	ijzerverbinding	ZNW:EKV:VRK:HET
ijzerverbindingetjes	ijzerverbinding	ZNW:MRV:VRK:DE_
inbelverbindingetje	inbelverbinding	ZNW:EKV:VRK:HET
inbelverbindingetjes	inbelverbinding	ZNW:MRV:VRK:DE_
infraroodverbindingetje	infraroodverbinding	ZNW:EKV:VRK:HET
infraroodverbindingetjes	infraroodverbinding	ZNW:MRV:VRK:DE_
insteekverbindingetje	insteekverbinding	ZNW:EKV:VRK:HET
insteekverbindingetjes	insteekverbinding	ZNW:MRV:VRK:DE_
intercomverbindingetje	intercomverbinding	ZNW:EKV:VRK:HET
intercomverbindingetjes	intercomverbinding	ZNW:MRV:VRK:DE_
internetbankierden	internetbankierden	ZNW:EKV:DE_
internetbankierend	internetbankierend	ZNW:EKV:HET
internetverbindingetje	internetverbinding	ZNW:EKV:VRK:HET
internetverbindingetjes	internetverbinding	ZNW:MRV:VRK:DE_
ionenverbindingetje	ionenverbinding	ZNW:EKV:VRK:HET
ionenverbindingetjes	ionenverbinding	ZNW:MRV:VRK:DE_
jaarverbindingetje	jaarverbinding	ZNW:EKV:VRK:HET
jaarverbindingetjes	jaarverbinding	ZNW:MRV:VRK:DE_
jazzbanden	jazzband	ZNW:MRV:DE_
jeugdboekenweek	jeugdboekenweek	ZNW:EKV
jodiumhoudende	jodiumhoudende	BNW:STL:VRB
jodiumverbindingetje	jodiumverbinding	ZNW:EKV:VRK:HET
jodiumverbindingetjes	jodiumverbinding	ZNW:MRV:VRK:DE_
kabelbaanverbindingetje	kabelbaanverbinding	ZNW:EKV:VRK:HET
kabelbaanverbindingetjes	kabelbaanverbinding	ZNW:MRV:VRK:DE_
kabelmodemverbindingetje	kabelmodemverbinding	ZNW:EKV:VRK:HET
kabelmodemverbindingetjes	kabelmodemverbinding	ZNW:MRV:VRK:DE_
kabelschroefverbindingetje	kabelschroefverbinding	ZNW:EKV:VRK:HET
kabelschroefverbindingetjes	kabelschroefverbinding	ZNW:MRV:VRK:DE_
kabelverbindingetje	kabelverbinding	ZNW:EKV:VRK:HET
kabelverbindingetjes	kabelverbinding	ZNW:MRV:VRK:DE_
kanaalverbindingetje	kanaalverbinding	ZNW:EKV:VRK:HET
kanaalverbindingetjes	kanaalverbinding	ZNW:MRV:VRK:DE_
kanoverbindingetje	kanoverbinding	ZNW:EKV:VRK:HET
kanoverbindingetjes	kanoverbinding	ZNW:MRV:VRK:DE_
kernverbindingetje	kernverbinding	ZNW:EKV:VRK:HET
kernverbindingetjes	kernverbinding	ZNW:MRV:VRK:DE_
ketenverbindingetje	ketenverbinding	ZNW:EKV:VRK:HET
ketenverbindingetjes	ketenverbinding	ZNW:MRV:VRK:DE_
kettingsverbindingetje	kettingsverbinding	ZNW:EKV:VRK:HET
kettingsverbindingetjes	kettingsverbinding	ZNW:MRV:VRK:DE_
kettingverbindingetje	kettingverbinding	ZNW:EKV:VRK:HET
kettingverbindingetjes	kettingverbinding	ZNW:MRV:VRK:DE_
kiesverbindingetje	kiesverbinding	ZNW:EKV:VRK:HET
kiesverbindingetjes	kiesverbinding	ZNW:MRV:VRK:DE_
klemverbindingetje	klemverbinding	ZNW:EKV:VRK:HET
klemverbindingetjes	klemverbinding	ZNW:MRV:VRK:DE_
klinknagelverbindingetje	klinknagelverbinding	ZNW:EKV:VRK:HET
klinknagelverbindingetjes	klinknagelverbinding	ZNW:MRV:VRK:DE_
klinkverbindingetje	klinkverbinding	ZNW:EKV:VRK:HET
klinkverbindingetjes	klinkverbinding	ZNW:MRV:VRK:DE_
klittenbandverbindingetje	klittenbandverbinding	ZNW:EKV:VRK:HET
klittenbandverbindingetjes	klittenbandverbinding	ZNW:MRV:VRK:DE_
knieverbindingetje	knieverbinding	ZNW:EKV:VRK:HET
knieverbindingetjes	knieverbinding	ZNW:MRV:VRK:DE_
kobaltverbindingetje	kobaltverbinding	ZNW:EKV:VRK:HET
kobaltverbindingetjes	kobaltverbinding	ZNW:MRV:VRK:DE_
kogelverbindingetje	kogelverbinding	ZNW:EKV:VRK:HET
kogelverbindingetjes	kogelverbinding	ZNW:MRV:VRK:DE_
koolstofverbindingetje	koolstofverbinding	ZNW:EKV:VRK:HET
koolstofverbindingetjes	koolstofverbinding	ZNW:MRV:VRK:DE_
koolwaterstofverbindingetje	koolwaterstofverbinding	ZNW:EKV:VRK:HET
koolwaterstofverbindingetjes	koolwaterstofverbinding	ZNW:MRV:VRK:DE_
koperdraadverbindingetje	koperdraadverbinding	ZNW:EKV:VRK:HET
koperdraadverbindingetjes	koperdraadverbinding	ZNW:MRV:VRK:DE_
koperverbindingetje	koperverbinding	ZNW:EKV:VRK:HET
koperverbindingetjes	koperverbinding	ZNW:MRV:VRK:DE_
koppelverbindingetje	koppelverbinding	ZNW:EKV:VRK:HET
koppelverbindingetjes	koppelverbinding	ZNW:MRV:VRK:DE_
kraakbeenverbindingetje	kraakbeenverbinding	ZNW:EKV:VRK:HET
kraakbeenverbindingetjes	kraakbeenverbinding	ZNW:MRV:VRK:DE_
krengend	krengend	ZNW:EKV:HET
krimpverbindingetje	krimpverbinding	ZNW:EKV:VRK:HET
krimpverbindingetjes	krimpverbinding	ZNW:MRV:VRK:DE_
kristalverbindingetje	kristalverbinding	ZNW:EKV:VRK:HET
kristalverbindingetjes	kristalverbinding	ZNW:MRV:VRK:DE_
kruisverbindingetje	kruisverbinding	ZNW:EKV:VRK:HET
kruisverbindingetjes	kruisverbinding	ZNW:MRV:VRK:DE_
kwaliteitsverbindingetje	kwaliteitsverbinding	ZNW:EKV:VRK:HET
kwaliteitsverbindingetjes	kwaliteitsverbinding	ZNW:MRV:VRK:DE_
kwikverbindingetje	kwikverbinding	ZNW:EKV:VRK:HET
kwikverbindingetjes	kwikverbinding	ZNW:MRV:VRK:DE_
laagspanningsverbindingetje	laagspanningsverbinding	ZNW:EKV:VRK:HET
laagspanningsverbindingetjes	laagspanningsverbinding	ZNW:MRV:VRK:DE_
landverbindingetje	landverbinding	ZNW:EKV:VRK:HET
landverbindingetjes	landverbinding	ZNW:MRV:VRK:DE_
laptopverbindingetje	laptopverbinding	ZNW:EKV:VRK:HET
laptopverbindingetjes	laptopverbinding	ZNW:MRV:VRK:DE_
laserlasverbindingetje	laserlasverbinding	ZNW:EKV:VRK:HET
laserlasverbindingetjes	laserlasverbinding	ZNW:MRV:VRK:DE_
laserverbindingetje	laserverbinding	ZNW:EKV:VRK:HET
laserverbindingetjes	laserverbinding	ZNW:MRV:VRK:DE_
letterverbindingetje	letterverbinding	ZNW:EKV:VRK:HET
letterverbindingetjes	letterverbinding	ZNW:MRV:VRK:DE_
lichtverbindingetje	lichtverbinding	ZNW:EKV:VRK:HET
lichtverbindingetjes	lichtverbinding	ZNW:MRV:VRK:DE_
liefdesverbindingetje	liefdesverbinding	ZNW:EKV:VRK:HET
liefdesverbindingetjes	liefdesverbinding	ZNW:MRV:VRK:DE_
lightrailverbindingetje	lightrailverbinding	ZNW:EKV:VRK:HET
lightrailverbindingetjes	lightrailverbinding	ZNW:MRV:VRK:DE_
lijmverbindingetje	lijmverbinding	ZNW:EKV:VRK:HET
lijmverbindingetjes	lijmverbinding	ZNW:MRV:VRK:DE_
lijnverbindingetje	lijnverbinding	ZNW:EKV:VRK:HET
lijnverbindingetjes	lijnverbinding	ZNW:MRV:VRK:DE_
lijstverbindingetje	lijstverbinding	ZNW:EKV:VRK:HET
lijstverbindingetjes	lijstverbinding	ZNW:MRV:VRK:DE_
loodverbindingetje	loodverbinding	ZNW:EKV:VRK:HET
loodverbindingetjes	loodverbinding	ZNW:MRV:VRK:DE_
losslaand	losslaand	BNW:STL:ONV
luchtvaartverbindingetje	luchtvaartverbinding	ZNW:EKV:VRK:HET
luchtvaartverbindingetjes	luchtvaartverbinding	ZNW:MRV:VRK:DE_
luchtverbindingetje	luchtverbinding	ZNW:EKV:VRK:HET
luchtverbindingetjes	luchtverbinding	ZNW:MRV:VRK:DE_
luisterverbindingetje	luisterverbinding	ZNW:EKV:VRK:HET
luisterverbindingetjes	luisterverbinding	ZNW:MRV:VRK:DE_
m/s	m/s	UNSPECIFIED
magneettreinverbindingetje	magneettreinverbinding	ZNW:EKV:VRK:HET
magneettreinverbindingetjes	magneettreinverbinding	ZNW:MRV:VRK:DE_
magneetverbindingetje	magneetverbinding	ZNW:EKV:VRK:HET
magneetverbindingetjes	magneetverbinding	ZNW:MRV:VRK:DE_
magnesiumverbindingetje	magnesiumverbinding	ZNW:EKV:VRK:HET
magnesiumverbindingetjes	magnesiumverbinding	ZNW:MRV:VRK:DE_
manchetverbindingetje	manchetverbinding	ZNW:EKV:VRK:HET
manchetverbindingetjes	manchetverbinding	ZNW:MRV:VRK:DE_
marifoonverbindingetje	marifoonverbinding	ZNW:EKV:VRK:HET
marifoonverbindingetjes	marifoonverbinding	ZNW:MRV:VRK:DE_
massaverbindingetje	massaverbinding	ZNW:EKV:VRK:HET
massaverbindingetjes	massaverbinding	ZNW:MRV:VRK:DE_
materiaalverbindingetje	materiaalverbinding	ZNW:EKV:VRK:HET
materiaalverbindingetjes	materiaalverbinding	ZNW:MRV:VRK:DE_
matrixverbindingetje	matrixverbinding	ZNW:EKV:VRK:HET
matrixverbindingetjes	matrixverbinding	ZNW:MRV:VRK:DE_
media-offensief	media-offensief	UNSPECIFIED
metaalhoudende	metaalhoudende	BNW:STL:VRB
metaalverbindingetje	metaalverbinding	ZNW:EKV:VRK:HET
metaalverbindingetjes	metaalverbinding	ZNW:MRV:VRK:DE_
metroverbindingetje	metroverbinding	ZNW:EKV:VRK:HET
metroverbindingetjes	metroverbinding	ZNW:MRV:VRK:DE_
microfoonverbindingetje	microfoonverbinding	ZNW:EKV:VRK:HET
microfoonverbindingetjes	microfoonverbinding	ZNW:MRV:VRK:DE_
microgolfverbindingetje	microgolfverbinding	ZNW:EKV:VRK:HET
microgolfverbindingetjes	microgolfverbinding	ZNW:MRV:VRK:DE_
microverbindingetje	microverbinding	ZNW:EKV:VRK:HET
microverbindingetjes	microverbinding	ZNW:MRV:VRK:DE_
mineraalverbindingetje	mineraalverbinding	ZNW:EKV:VRK:HET
mineraalverbindingetjes	mineraalverbinding	ZNW:MRV:VRK:DE_
minibusverbindingetje	minibusverbinding	ZNW:EKV:VRK:HET
minibusverbindingetjes	minibusverbinding	ZNW:MRV:VRK:DE_
mode-accessoire	mode-accessoire	UNSPECIFIED
modelverbindingetje	modelverbinding	ZNW:EKV:VRK:HET
modelverbindingetjes	modelverbinding	ZNW:MRV:VRK:DE_
modemverbindingetje	modemverbinding	ZNW:EKV:VRK:HET
modemverbindingetjes	modemverbinding	ZNW:MRV:VRK:DE_
moederverbindingetje	moederverbinding	ZNW:EKV:VRK:HET
moederverbindingetjes	moederverbinding	ZNW:MRV:VRK:DE_
mosterdolieverbindingetje	mosterdolieverbinding	ZNW:EKV:VRK:HET
mosterdolieverbindingetjes	mosterdolieverbinding	ZNW:MRV:VRK:DE_
naadverbindingetje	naadverbinding	ZNW:EKV:VRK:HET
naadverbindingetjes	naadverbinding	ZNW:MRV:VRK:DE_
nachtverbindingetje	nachtverbinding	ZNW:EKV:VRK:HET
nachtverbindingetjes	nachtverbinding	ZNW:MRV:VRK:DE_
natriumverbindingetje	natriumverbinding	ZNW:EKV:VRK:HET
natriumverbindingetjes	natriumverbinding	ZNW:MRV:VRK:DE_
natuurverbindingetje	natuurverbinding	ZNW:EKV:VRK:HET
natuurverbindingetjes	natuurverbinding	ZNW:MRV:VRK:DE_
navelstrengverbindingetje	navelstrengverbinding	ZNW:EKV:VRK:HET
navelstrengverbindingetjes	navelstrengverbinding	ZNW:MRV:VRK:DE_
nazi-verleden	nazi-verleden	UNSPECIFIED
netwerkverbindingetje	netwerkverbinding	ZNW:EKV:VRK:HET
netwerkverbindingetjes	netwerkverbinding	ZNW:MRV:VRK:DE_
niet-gebruikelijk	niet-gebruikelijk	BNW:STL:VRB
niet-parlementair	niet-parlementair	BNW:STL:VRB
nitraatverbindingetje	nitraatverbinding	ZNW:EKV:VRK:HET
nitraatverbindingetjes	nitraatverbinding	ZNW:MRV:VRK:DE_
nitroverbindingetje	nitroverbinding	ZNW:EKV:VRK:HET
nitroverbindingetjes	nitroverbinding	ZNW:MRV:VRK:DE_
noodverbindingetje	noodverbinding	ZNW:EKV:VRK:HET
noodverbindingetjes	noodverbinding	ZNW:MRV:VRK:DE_
noord-zuidverbindingetje	noord-zuidverbinding	ZNW:EKV:VRK:HET
noord-zuidverbindingetjes	noord-zuidverbinding	ZNW:MRV:VRK:DE_
oeverbindingetje	oeverbinding	ZNW:EKV:VRK:HET
oeverbindingetjes	oeverbinding	ZNW:MRV:VRK:DE_
oeververbindingetje	oeververbinding	ZNW:EKV:VRK:HET
oeververbindingetjes	oeververbinding	ZNW:MRV:VRK:DE_
olieverbindingetje	olieverbinding	ZNW:EKV:VRK:HET
olieverbindingetjes	olieverbinding	ZNW:MRV:VRK:DE_
omroepverbindingetje	omroepverbinding	ZNW:EKV:VRK:HET
omroepverbindingetjes	omroepverbinding	ZNW:MRV:VRK:DE_
onderwaterverbindingetje	onderwaterverbinding	ZNW:EKV:VRK:HET
onderwaterverbindingetjes	onderwaterverbinding	ZNW:MRV:VRK:DE_
onlineverbindingetje	onlineverbinding	ZNW:EKV:VRK:HET
onlineverbindingetjes	onlineverbinding	ZNW:MRV:VRK:DE_
oproepverbindingetje	oproepverbinding	ZNW:EKV:VRK:HET
oproepverbindingetjes	oproepverbinding	ZNW:MRV:VRK:DE_
overgangsverbindingetje	overgangsverbinding	ZNW:EKV:VRK:HET
overgangsverbindingetjes	overgangsverbinding	ZNW:MRV:VRK:DE_
overlappingsverbindingetje	overlappingsverbinding	ZNW:EKV:VRK:HET
overlappingsverbindingetjes	overlappingsverbinding	ZNW:MRV:VRK:DE_
overlapverbindingetje	overlapverbinding	ZNW:EKV:VRK:HET
overlapverbindingetjes	overlapverbinding	ZNW:MRV:VRK:DE_
overstapverbindingetje	overstapverbinding	ZNW:EKV:VRK:HET
overstapverbindingetjes	overstapverbinding	ZNW:MRV:VRK:DE_
parallelverbindingetjes	parallelverbinding	ZNW:MRV:VRK:DE_
passagiersverbindingetje	passagiersverbinding	ZNW:EKV:VRK:HET
passagiersverbindingetjes	passagiersverbinding	ZNW:MRV:VRK:DE_
pechhaven	pechhaven	UNSPECIFIED
pendelverbindingetje	pendelverbinding	ZNW:EKV:VRK:HET
pendelverbindingetjes	pendelverbinding	ZNW:MRV:VRK:DE_
persverbindingetje	persverbinding	ZNW:EKV:VRK:HET
persverbindingetjes	persverbinding	ZNW:MRV:VRK:DE_
pijplijnverbindingetje	pijplijnverbinding	ZNW:EKV:VRK:HET
pijplijnverbindingetjes	pijplijnverbinding	ZNW:MRV:VRK:DE_
pisteverbindingetje	pisteverbinding	ZNW:EKV:VRK:HET
pisteverbindingetjes	pisteverbinding	ZNW:MRV:VRK:DE_
plaatsenverbindingetje	plaatsenverbinding	ZNW:EKV:VRK:HET
plaatsenverbindingetjes	plaatsenverbinding	ZNW:MRV:VRK:DE_
platinaverbindingetje	platinaverbinding	ZNW:EKV:VRK:HET
platinaverbindingetjes	platinaverbinding	ZNW:MRV:VRK:DE_
platvormpje	platvorm	ZNW:EKV:VRK:HET
polyesterverbindingetje	polyesterverbinding	ZNW:EKV:VRK:HET
polyesterverbindingetjes	polyesterverbinding	ZNW:MRV:VRK:DE_
pontverbindingetje	pontverbinding	ZNW:EKV:VRK:HET
pontverbindingetjes	pontverbinding	ZNW:MRV:VRK:DE_
poortverbindingetje	poortverbinding	ZNW:EKV:VRK:HET
poortverbindingetjes	poortverbinding	ZNW:MRV:VRK:DE_
postverbindingetje	postverbinding	ZNW:EKV:VRK:HET
postverbindingetjes	postverbinding	ZNW:MRV:VRK:DE_
privéverbindingetje	privéverbinding	ZNW:EKV:VRK:HET
privéverbindingetjes	privéverbinding	ZNW:MRV:VRK:DE_
procesverbindingetje	procesverbinding	ZNW:EKV:VRK:HET
procesverbindingetjes	procesverbinding	ZNW:MRV:VRK:DE_
productverbindingetje	productverbinding	ZNW:EKV:VRK:HET
productverbindingetjes	productverbinding	ZNW:MRV:VRK:DE_
profielverbindingetje	profielverbinding	ZNW:EKV:VRK:HET
profielverbindingetjes	profielverbinding	ZNW:MRV:VRK:DE_
punkbanden	punkband	ZNW:MRV:DE_
radioverbindingetje	radioverbinding	ZNW:EKV:VRK:HET
radioverbindingetjes	radioverbinding	ZNW:MRV:VRK:DE_
railverbindingetje	railverbinding	ZNW:EKV:VRK:HET
railverbindingetjes	railverbinding	ZNW:MRV:VRK:DE_
randverbindingetje	randverbinding	ZNW:EKV:VRK:HET
randverbindingetjes	randverbinding	ZNW:MRV:VRK:DE_
recreatieverbindingetje	recreatieverbinding	ZNW:EKV:VRK:HET
recreatieverbindingetjes	recreatieverbinding	ZNW:MRV:VRK:DE_
referentieverbindingetje	referentieverbinding	ZNW:EKV:VRK:HET
referentieverbindingetjes	referentieverbinding	ZNW:MRV:VRK:DE_
reizigersverbindingetje	reizigersverbinding	ZNW:EKV:VRK:HET
reizigersverbindingetjes	reizigersverbinding	ZNW:MRV:VRK:DE_
relschoppende	relschoppende	BNW:STL:VRB
ringverbindingetje	ringverbinding	ZNW:EKV:VRK:HET
ringverbindingetjes	ringverbinding	ZNW:MRV:VRK:DE_
rioolverbindingetje	rioolverbinding	ZNW:EKV:VRK:HET
rioolverbindingetjes	rioolverbinding	ZNW:MRV:VRK:DE_
rubberverbindingetje	rubberverbinding	ZNW:EKV:VRK:HET
rubberverbindingetjes	rubberverbinding	ZNW:MRV:VRK:DE_
ruimteverbindingetje	ruimteverbinding	ZNW:EKV:VRK:HET
ruimteverbindingetjes	ruimteverbinding	ZNW:MRV:VRK:DE_
ruiterverbindingetje	ruiterverbinding	ZNW:EKV:VRK:HET
ruiterverbindingetjes	ruiterverbinding	ZNW:MRV:VRK:DE_
satellietverbindingetje	satellietverbinding	ZNW:EKV:VRK:HET
satellietverbindingetjes	satellietverbinding	ZNW:MRV:VRK:DE_
scharnierverbindingetje	scharnierverbinding	ZNW:EKV:VRK:HET
scharnierverbindingetjes	scharnierverbinding	ZNW:MRV:VRK:DE_
scheepsverbindingetje	scheepsverbinding	ZNW:EKV:VRK:HET
scheepsverbindingetjes	scheepsverbinding	ZNW:MRV:VRK:DE_
scheepvaartverbindingetje	scheepvaartverbinding	ZNW:EKV:VRK:HET
scheepvaartverbindingetjes	scheepvaartverbinding	ZNW:MRV:VRK:DE_
schroefdraadverbindingetje	schroefdraadverbinding	ZNW:EKV:VRK:HET
schroefdraadverbindingetjes	schroefdraadverbinding	ZNW:MRV:VRK:DE_
schroefverbindingetje	schroefverbinding	ZNW:EKV:VRK:HET
schroefverbindingetjes	schroefverbinding	ZNW:MRV:VRK:DE_
schuifverbindingetje	schuifverbinding	ZNW:EKV:VRK:HET
schuifverbindingetjes	schuifverbinding	ZNW:MRV:VRK:DE_
serververbindingetje	serververbinding	ZNW:EKV:VRK:HET
serververbindingetjes	serververbinding	ZNW:MRV:VRK:DE_
shuttlebusverbindingetje	shuttlebusverbinding	ZNW:EKV:VRK:HET
shuttlebusverbindingetjes	shuttlebusverbinding	ZNW:MRV:VRK:DE_
shuttleverbindingetje	shuttleverbinding	ZNW:EKV:VRK:HET
shuttleverbindingetjes	shuttleverbinding	ZNW:MRV:VRK:DE_
signaalverbindingetje	signaalverbinding	ZNW:EKV:VRK:HET
signaalverbindingetjes	signaalverbinding	ZNW:MRV:VRK:DE_
siliciumverbindingetje	siliciumverbinding	ZNW:EKV:VRK:HET
siliciumverbindingetjes	siliciumverbinding	ZNW:MRV:VRK:DE_
singelverbindingetje	singelverbinding	ZNW:EKV:VRK:HET
singelverbindingetjes	singelverbinding	ZNW:MRV:VRK:DE_
skibusverbindingetje	skibusverbinding	ZNW:EKV:VRK:HET
skibusverbindingetjes	skibusverbinding	ZNW:MRV:VRK:DE_
sleepverbindingetje	sleepverbinding	ZNW:EKV:VRK:HET
sleepverbindingetjes	sleepverbinding	ZNW:MRV:VRK:DE_
sluisverbindingetje	sluisverbinding	ZNW:EKV:VRK:HET
sluisverbindingetjes	sluisverbinding	ZNW:MRV:VRK:DE_
smalspoorverbindingetje	smalspoorverbinding	ZNW:EKV:VRK:HET
smalspoorverbindingetjes	smalspoorverbinding	ZNW:MRV:VRK:DE_
snelbusverbindingetje	snelbusverbinding	ZNW:EKV:VRK:HET
snelbusverbindingetjes	snelbusverbinding	ZNW:MRV:VRK:DE_
snelheidsverbindingetje	snelheidsverbinding	ZNW:EKV:VRK:HET
snelheidsverbindingetjes	snelheidsverbinding	ZNW:MRV:VRK:DE_
sneltramverbindingetje	sneltramverbinding	ZNW:EKV:VRK:HET
sneltramverbindingetjes	sneltramverbinding	ZNW:MRV:VRK:DE_
sneltreinverbindingetje	sneltreinverbinding	ZNW:EKV:VRK:HET
sneltreinverbindingetjes	sneltreinverbinding	ZNW:MRV:VRK:DE_
snelwegverbindingetje	snelwegverbinding	ZNW:EKV:VRK:HET
snelwegverbindingetjes	snelwegverbinding	ZNW:MRV:VRK:DE_
socialezekerheidswetgevingen	socialezekerheidswetgevingen	ZNW:MRV:DE_
soldeerverbindingetje	soldeerverbinding	ZNW:EKV:VRK:HET
spijkerverbindingetje	spijkerverbinding	ZNW:EKV:VRK:HET
spijkerverbindingetjes	spijkerverbinding	ZNW:MRV:VRK:DE_
spiraalverbindingetje	spiraalverbinding	ZNW:EKV:VRK:HET
spiraalverbindingetjes	spiraalverbinding	ZNW:MRV:VRK:DE_
spitsverbindingetje	spitsverbinding	ZNW:EKV:VRK:HET
spitsverbindingetjes	spitsverbinding	ZNW:MRV:VRK:DE_
spoorlijnverbindingetje	spoorlijnverbinding	ZNW:EKV:VRK:HET
spoorlijnverbindingetjes	spoorlijnverbinding	ZNW:MRV:VRK:DE_
spoorverbindingetje	spoorverbinding	ZNW:EKV:VRK:HET
spoorverbindingetjes	spoorverbinding	ZNW:MRV:VRK:DE_
spoorwegverbindingetje	spoorwegverbinding	ZNW:EKV:VRK:HET
spoorwegverbindingetjes	spoorwegverbinding	ZNW:MRV:VRK:DE_
spraakverbindingetje	spraakverbinding	ZNW:EKV:VRK:HET
spraakverbindingetjes	spraakverbinding	ZNW:MRV:VRK:DE_
spreekverbindingetje	spreekverbinding	ZNW:EKV:VRK:HET
spreekverbindingetjes	spreekverbinding	ZNW:MRV:VRK:DE_
staafverbindingetje	staafverbinding	ZNW:EKV:VRK:HET
staafverbindingetjes	staafverbinding	ZNW:MRV:VRK:DE_
staalverbindingetje	staalverbinding	ZNW:EKV:VRK:HET
staalverbindingetjes	staalverbinding	ZNW:MRV:VRK:DE_
stadsverbindingetje	stadsverbinding	ZNW:EKV:VRK:HET
stadsverbindingetjes	stadsverbinding	ZNW:MRV:VRK:DE_
standaardverbindingetje	standaardverbinding	ZNW:EKV:VRK:HET
standaardverbindingetjes	standaardverbinding	ZNW:MRV:VRK:DE_
steekverbindingetje	steekverbinding	ZNW:EKV:VRK:HET
steekverbindingetjes	steekverbinding	ZNW:MRV:VRK:DE_
steelverbindingetje	steelverbinding	ZNW:EKV:VRK:HET
steelverbindingetjes	steelverbinding	ZNW:MRV:VRK:DE_
stekkerverbindingetje	stekkerverbinding	ZNW:EKV:VRK:HET
stekkerverbindingetjes	stekkerverbinding	ZNW:MRV:VRK:DE_
steunverbindingetje	steunverbinding	ZNW:EKV:VRK:HET
steunverbindingetjes	steunverbinding	ZNW:MRV:VRK:DE_
stikstofverbindingetje	stikstofverbinding	ZNW:EKV:VRK:HET
stikstofverbindingetjes	stikstofverbinding	ZNW:MRV:VRK:DE_
stofeigenschap	stofeigenschap	ZNW:EKV
stofeigenschappen	stofeigenschappen	ZNW:MRV:DE_
stoomtramverbindingetje	stoomtramverbinding	ZNW:EKV:VRK:HET
stoomtramverbindingetjes	stoomtramverbinding	ZNW:MRV:VRK:DE_
stoomtreinverbindingetje	stoomtreinverbinding	ZNW:EKV:VRK:HET
stoomtreinverbindingetjes	stoomtreinverbinding	ZNW:MRV:VRK:DE_
stoomvaartverbindingetje	stoomvaartverbinding	ZNW:EKV:VRK:HET
stoomvaartverbindingetjes	stoomvaartverbinding	ZNW:MRV:VRK:DE_
stoomverbindingetje	stoomverbinding	ZNW:EKV:VRK:HET
stoomverbindingetjes	stoomverbinding	ZNW:MRV:VRK:DE_
stootverbindingetje	stootverbinding	ZNW:EKV:VRK:HET
stootverbindingetjes	stootverbinding	ZNW:MRV:VRK:DE_
stoptreinverbindingetje	stoptreinverbinding	ZNW:EKV:VRK:HET
stoptreinverbindingetjes	stoptreinverbinding	ZNW:MRV:VRK:DE_
straalverbindingetje	straalverbinding	ZNW:EKV:VRK:HET
straalverbindingetjes	straalverbinding	ZNW:MRV:VRK:DE_
stripverbindingetje	stripverbinding	ZNW:EKV:VRK:HET
stripverbindingetjes	stripverbinding	ZNW:MRV:VRK:DE_
stroomverbindingetje	stroomverbinding	ZNW:EKV:VRK:HET
stroomverbindingetjes	stroomverbinding	ZNW:MRV:VRK:DE_
suikerverbindingetje	suikerverbinding	ZNW:EKV:VRK:HET
suikerverbindingetjes	suikerverbinding	ZNW:MRV:VRK:DE_
superverbindingetje	superverbinding	ZNW:EKV:VRK:HET
superverbindingetjes	superverbinding	ZNW:MRV:VRK:DE_
systeemverbindingetje	systeemverbinding	ZNW:EKV:VRK:HET
systeemverbindingetjes	systeemverbinding	ZNW:MRV:VRK:DE_
taxiverbindingetje	taxiverbinding	ZNW:EKV:VRK:HET
taxiverbindingetjes	taxiverbinding	ZNW:MRV:VRK:DE_
tekstverbindingetje	tekstverbinding	ZNW:EKV:VRK:HET
tekstverbindingetjes	tekstverbinding	ZNW:MRV:VRK:DE_
telecomverbindingetje	telecomverbinding	ZNW:EKV:VRK:HET
telecomverbindingetjes	telecomverbinding	ZNW:MRV:VRK:DE_
telefonieverbindingetje	telefonieverbinding	ZNW:EKV:VRK:HET
telefonieverbindingetjes	telefonieverbinding	ZNW:MRV:VRK:DE_
telefoonverbindingetje	telefoonverbinding	ZNW:EKV:VRK:HET
telefoonverbindingetjes	telefoonverbinding	ZNW:MRV:VRK:DE_
telegraafverbindingetje	telegraafverbinding	ZNW:EKV:VRK:HET
telegraafverbindingetjes	telegraafverbinding	ZNW:MRV:VRK:DE_
telegrafieverbindingetje	telegrafieverbinding	ZNW:EKV:VRK:HET
telegrafieverbindingetjes	telegrafieverbinding	ZNW:MRV:VRK:DE_
televisieverbindingetje	televisieverbinding	ZNW:EKV:VRK:HET
televisieverbindingetjes	televisieverbinding	ZNW:MRV:VRK:DE_
telexverbindingetje	telexverbinding	ZNW:EKV:VRK:HET
telexverbindingetjes	telexverbinding	ZNW:MRV:VRK:DE_
testverbindingetje	testverbinding	ZNW:EKV:VRK:HET
testverbindingetjes	testverbinding	ZNW:MRV:VRK:DE_
thuisverbindingetje	thuisverbinding	ZNW:EKV:VRK:HET
thuisverbindingetjes	thuisverbinding	ZNW:MRV:VRK:DE_
toegangsverbindingetje	toegangsverbinding	ZNW:EKV:VRK:HET
toegangsverbindingetjes	toegangsverbinding	ZNW:MRV:VRK:DE_
totaalverbindingetje	totaalverbinding	ZNW:EKV:VRK:HET
totaalverbindingetjes	totaalverbinding	ZNW:MRV:VRK:DE_
tramverbindingetje	tramverbinding	ZNW:EKV:VRK:HET
tramverbindingetjes	tramverbinding	ZNW:MRV:VRK:DE_
transmissieverbindingetje	transmissieverbinding	ZNW:EKV:VRK:HET
transmissieverbindingetjes	transmissieverbinding	ZNW:MRV:VRK:DE_
transportverbindingetje	transportverbinding	ZNW:EKV:VRK:HET
transportverbindingetjes	transportverbinding	ZNW:MRV:VRK:DE_
trappenhuisverbindingetje	trappenhuisverbinding	ZNW:EKV:VRK:HET
trappenhuisverbindingetjes	trappenhuisverbinding	ZNW:MRV:VRK:DE_
treinverbindingetje	treinverbinding	ZNW:EKV:VRK:HET
treinverbindingetjes	treinverbinding	ZNW:MRV:VRK:DE_
tunnelverbindingetje	tunnelverbinding	ZNW:EKV:VRK:HET
tunnelverbindingetjes	tunnelverbinding	ZNW:MRV:VRK:DE_
tv-persoonlijkheden	tv-persoonlijkheden	UNSPECIFIED
uitbreidingsverbindingetje	uitbreidingsverbinding	ZNW:EKV:VRK:HET
uitbreidingsverbindingetjes	uitbreidingsverbinding	ZNW:MRV:VRK:DE_
uitgangsverbindingetje	uitgangsverbinding	ZNW:EKV:VRK:HET
uitgangsverbindingetjes	uitgangsverbinding	ZNW:MRV:VRK:DE_
uitlaatverbindingetje	uitlaatverbinding	ZNW:EKV:VRK:HET
uitlaatverbindingetjes	uitlaatverbinding	ZNW:MRV:VRK:DE_
uraniumverbindingetje	uraniumverbinding	ZNW:EKV:VRK:HET
uraniumverbindingetjes	uraniumverbinding	ZNW:MRV:VRK:DE_
vaartverbindingetje	vaartverbinding	ZNW:EKV:VRK:HET
vaartverbindingetjes	vaartverbinding	ZNW:MRV:VRK:DE_
vaarverbindingetje	vaarverbinding	ZNW:EKV:VRK:HET
vaarverbindingetjes	vaarverbinding	ZNW:MRV:VRK:DE_
vaarwegverbindingetje	vaarwegverbinding	ZNW:EKV:VRK:HET
vaarwegverbindingetjes	vaarwegverbinding	ZNW:MRV:VRK:DE_
veerverbindingetje	veerverbinding	ZNW:EKV:VRK:HET
veerverbindingetjes	veerverbinding	ZNW:MRV:VRK:DE_
ventielverbindingetje	ventielverbinding	ZNW:EKV:VRK:HET
ventielverbindingetjes	ventielverbinding	ZNW:MRV:VRK:DE_
verbindingetje	verbinding	ZNW:EKV:VRK:HET
verbindingetjes	verbinding	ZNW:MRV:VRK:DE_
verkeersverbindingetje	verkeersverbinding	ZNW:EKV:VRK:HET
verkeersverbindingetjes	verkeersverbinding	ZNW:MRV:VRK:DE_
verstekverbindingetje	verstekverbinding	ZNW:EKV:VRK:HET
verstekverbindingetjes	verstekverbinding	ZNW:MRV:VRK:DE_
vervoersverbindingetje	vervoersverbinding	ZNW:EKV:VRK:HET
vervoersverbindingetjes	vervoersverbinding	ZNW:MRV:VRK:DE_
vervoerverbindingetje	vervoerverbinding	ZNW:EKV:VRK:HET
vervoerverbindingetjes	vervoerverbinding	ZNW:MRV:VRK:DE_
verwijzingsverbindingetje	verwijzingsverbinding	ZNW:EKV:VRK:HET
verwijzingsverbindingetjes	verwijzingsverbinding	ZNW:MRV:VRK:DE_
vezelverbindingetje	vezelverbinding	ZNW:EKV:VRK:HET
vezelverbindingetjes	vezelverbinding	ZNW:MRV:VRK:DE_
videoverbindingetje	videoverbinding	ZNW:EKV:VRK:HET
videoverbindingetjes	videoverbinding	ZNW:MRV:VRK:DE_
vingerlasverbindingetje	vingerlasverbinding	ZNW:EKV:VRK:HET
vingerlasverbindingetjes	vingerlasverbinding	ZNW:MRV:VRK:DE_
vliegtuigverbindingetje	vliegtuigverbinding	ZNW:EKV:VRK:HET
vliegtuigverbindingetjes	vliegtuigverbinding	ZNW:MRV:VRK:DE_
vliegverbindingetje	vliegverbinding	ZNW:EKV:VRK:HET
vliegverbindingetjes	vliegverbinding	ZNW:MRV:VRK:DE_
vluchtverbindingetje	vluchtverbinding	ZNW:EKV:VRK:HET
vluchtverbindingetjes	vluchtverbinding	ZNW:MRV:VRK:DE_
voetgangersverbindingetje	voetgangersverbinding	ZNW:EKV:VRK:HET
voetgangersverbindingetjes	voetgangersverbinding	ZNW:MRV:VRK:DE_
voetverbindingetje	voetverbinding	ZNW:EKV:VRK:HET
voetverbindingetjes	voetverbinding	ZNW:MRV:VRK:DE_
vrachtverbindingetje	vrachtverbinding	ZNW:EKV:VRK:HET
vrachtverbindingetjes	vrachtverbinding	ZNW:MRV:VRK:DE_
waarde-oordelen	waarde-oordelen	ZNW:MRV:DE_
wandelverbindingetje	wandelverbinding	ZNW:EKV:VRK:HET
wandelverbindingetjes	wandelverbinding	ZNW:MRV:VRK:DE_
waterbusverbindingetje	waterbusverbinding	ZNW:EKV:VRK:HET
waterbusverbindingetjes	waterbusverbinding	ZNW:MRV:VRK:DE_
waterverbindingetje	waterverbinding	ZNW:EKV:VRK:HET
waterverbindingetjes	waterverbinding	ZNW:MRV:VRK:DE_
webcamverbindingetje	webcamverbinding	ZNW:EKV:VRK:HET
webcamverbindingetjes	webcamverbinding	ZNW:MRV:VRK:DE_
websiteverbindingetje	websiteverbinding	ZNW:EKV:VRK:HET
websiteverbindingetjes	websiteverbinding	ZNW:MRV:VRK:DE_
wegenverbindingetje	wegenverbinding	ZNW:EKV:VRK:HET
wegenverbindingetjes	wegenverbinding	ZNW:MRV:VRK:DE_
wervelverbindingetje	wervelverbinding	ZNW:EKV:VRK:HET
wervelverbindingetjes	wervelverbinding	ZNW:MRV:VRK:DE_
wisselstroomverbindingetje	wisselstroomverbinding	ZNW:EKV:VRK:HET
wisselstroomverbindingetjes	wisselstroomverbinding	ZNW:MRV:VRK:DE_
wisselverbindingetje	wisselverbinding	ZNW:EKV:VRK:HET
wisselverbindingetjes	wisselverbinding	ZNW:MRV:VRK:DE_
woordverbindingetje	woordverbinding	ZNW:EKV:VRK:HET
woordverbindingetjes	woordverbinding	ZNW:MRV:VRK:DE_
zeeverbindingetje	zeeverbinding	ZNW:EKV:VRK:HET
zeeverbindingetjes	zeeverbinding	ZNW:MRV:VRK:DE_
zenuwverbindingetje	zenuwverbinding	ZNW:EKV:VRK:HET
zichtverbindingetje	zichtverbinding	ZNW:EKV:VRK:HET
zichtverbindingetjes	zichtverbinding	ZNW:MRV:VRK:DE_
ziekenhuisbreed	ziekenhuisbreed	BNW:STL:VRB
zilververbindingetje	zilververbinding	ZNW:EKV:VRK:HET
zilververbindingetjes	zilververbinding	ZNW:MRV:VRK:DE_
zoetwaterverbindingetje	zoetwaterverbinding	ZNW:EKV:VRK:HET
zoetwaterverbindingetjes	zoetwaterverbinding	ZNW:MRV:VRK:DE_
zuurstofverbindingetje	zuurstofverbinding	ZNW:EKV:VRK:HET
zuurstofverbindingetjes	zuurstofverbinding	ZNW:MRV:VRK:DE_
zwaluwstaartverbindingetje	zwaluwstaartverbinding	ZNW:EKV:VRK:HET
zwaluwstaartverbindingetjes	zwaluwstaartverbinding	ZNW:MRV:VRK:DE_
zwavelverbindingetje	zwavelverbinding	ZNW:EKV:VRK:HET
zwavelverbindingetjes	zwavelverbinding	ZNW:MRV:VRK:DE_
zwavelzuurverbindingetje	zwavelzuurverbinding	ZNW:EKV:VRK:HET
zwavelzuurverbindingetjes	zwavelzuurverbinding	ZNW:MRV:VRK:DE_
zweefverbindingetje	zweefverbinding	ZNW:EKV:VRK:HET
zweefverbindingetjes	zweefverbinding	ZNW:MRV:VRK:DE_
