angelic=angèlic
aurific=aurífic
autentic=autèntic
beatific=beatífic
benefic=benèfic
calcul=càlcul
critic=crític
diagnostic=diagnòstic
domestic=domèstic
especific=específic
flogistic=flogístic
honorific=honorífic
indic=índic
lubric=lúbric
medic=mèdic
mel·lific=mel·lífic
ossific=ossífic
pacific=pacífic
practic=pràctic
pronostic=pronòstic
public=públic
salud=salut
sindic=síndic
sofistic=sofístic
telefon=telèfon
trafic=tràfic
viatic=viàtic
vivific=vivífic
acid=àcid
ajud=ajut
avid=àvid
buid=buit
crid=crit
escud=escut
hibrid=híbrid
liquid=líquid
oxid=òxid
pared=paret
sed=set
solid=sòlid
valid=vàlid
